lf1	of
lf2	or
gl1	to
gl2	go
lh1	on
lh2	oh
sah1	say
sah2	way
ghdh1	they
ghdh2	then
hlg1	not
hlg2	hot
dah1	can
dah2	day
jh1	my
jh2	uh
gakd1	take
gakd2	bake
ljg1	out
ljg2	put
jjsg1	just
jjsg2	must
hljf1	your
hljf2	hour
dljd1	come
dljd2	clue
hls1	now
hls2	how
jlfd1	more
jlfd2	move
hds1	new
hds2	yes
jah1	man
jah2	may
fkhd1	find
fkhd2	fine
sdll1	well
sdll2	sell
gdll1	tell
gdll2	bell
js1	us
js2	ms
lkfd1	life
lkfd2	live
lasg1	last
lasg2	past
gll1	too
gll2	top
sgagd1	state
sgagd2	stage
shh1	why
shh2	shy
gfdag1	great
gfdag2	treat
gkg1	big
gkg2	bit
shls1	show
shls2	snow
dasd1	case
dasd2	ease
sddk1	week
sddk2	seek
fkghg1	right
fkghg2	fight
fjh1	run
fjh2	fun
hdsg1	next
hdsg2	nest
dhd1	eye
dhd2	end
skdd1	side
skdd2	wide
faghdf1	father
faghdf2	rather
llsdf1	power
llsdf2	lower
hdg1	yet
hdg2	net
lkhd1	line
lkhd2	pine
llsd1	lose
llsd2	pose
daf1	car
daf2	ear
fkfd1	five
fkfd2	fire
gdaj1	team
gdaj2	beam
fllg1	foot
fllg2	root
glh1	boy
glh2	toy
fdadh1	reach
fdadh2	ready
lagd1	late
lagd2	page
dlsd1	else
dlsd2	dose
skfd1	wife
skfd2	wire
jkhd1	mind
jkhd2	mine
lfkdd1	price
lfkdd2	pride
slh1	son
slh2	spy
gas1	tax
gas2	gas
gdadh1	teach
gdadh2	beach
lkl1	oil
lkl2	lip
lahd1	land
lahd2	lane
gagh1	baby
gagh2	bath
fdd1	red
fdd2	fee
gahk1	bank
gahk2	tank
gdd1	bed
gdd2	bee
dfll1	drop
dfll2	crop
jllh1	upon
jllh2	moon
sglfd1	store
sglfd2	stove
sljhd1	sound
sljhd2	wound
dasg1	east
dasg2	cast
dlg1	dog
dlg2	dot
gls1	box
gls2	bow
gkll1	bill
gkll2	till
fakl1	fail
fakl2	rail
slfg1	sort
slfg2	soft
dhddk1	check
dhddk2	cheek
dlld1	cold
dlld2	cope
hkdd1	nice
hkdd2	hide
gall1	ball
gall2	tall
shakd1	shake
shakd2	snake
gfkl1	trip
gfkl2	grip
slffh1	worry
slffh2	sorry
fdaf1	fear
fdaf2	rear
dfdaj1	dream
dfdaj2	cream
hdag1	heat
hdag2	neat
skhg1	sing
skhg2	wing
dahddf1	cancer
dahddf2	dancer
dladh1	coach
dladh2	dozen
skhd1	wind
skhd2	wine
fasg1	fast
fasg2	vast
fdfdf1	refer
fdfdf2	fever
dagd1	date
dagd2	cage
fah1	fan
fah2	van
shkl1	ship
shkl2	whip
sllg1	spot
sllg2	slot
ladk1	lack
ladk2	pack
glag1	boat
glag2	goat
slld1	wood
slld2	sole
skhgdf1	winter
skhgdf2	singer
fkllagd1	village
fkllagd2	violate
flll1	roll
flll2	fool
shald1	shape
shald2	whale
fkdd1	ride
fkdd2	rice
glll1	tool
glll2	toll
skld1	wild
skld2	wipe
gkgld1	title
gkgld2	bible
fkg1	fit
fkg2	rib
dfh1	cry
dfh2	dry
dlhgdsg1	context
dlhgdsg2	contest
asafd1	aware
asafd2	award
dlll1	cool
dlll2	doll
gald1	tape
gald2	tale
gkd1	tie
gkd2	bid
fag1	fat
fag2	rat
ljhdh1	lunch
ljhdh2	punch
sljl1	soul
sljl2	soup
gfdagh1	breath
gfdagh2	treaty
shkfg1	shift
shkfg2	shirt
lkhk1	link
lkhk2	pink
sakd1	wake
sakd2	sake
slkl1	slip
slkl2	soil
djd1	due
djd2	cue
gdhddf1	gender
gdhddf2	tender
flfgh1	forth
flfgh2	forty
ffajd1	frame
ffajd2	fraud
gllgh1	tooth
gllgh2	booth
fafd1	rare
fafd2	fare
gddf1	beer
gddf2	beef
sddd1	seed
sddd2	weed
gjsh1	busy
gjsh2	bush
gfah1	gray
gfah2	tray
dlfd1	core
dlfd2	cord
shddl1	wheel
shddl2	sheep
lag1	lab
lag2	pat
gal1	gap
gal2	tap
gfkdf1	brief
gfkdf2	grief
llsg1	post
llsg2	lost
sgddl1	steel
sgddl2	steep
slkdd1	slide
slkdd2	slice
gfahd1	grand
gfahd2	brand
glss1	boss
glss2	toss
gllg1	boot
gllg2	bolt
fljhd1	round
fljhd2	found
hllh1	holy
hllh2	noon
flag1	flag
flag2	flat
gjdk1	buck
gjdk2	tuck
fkfgh1	fifth
fkfgh2	fifty
jakl1	mail
jakl2	jail
dfafg1	draft
dfafg2	craft
fdgakh1	retain
fdgakh2	regain
slafd1	slave
slafd2	spare
gdsgjfd1	gesture
gdsgjfd2	texture
lkld1	pipe
lkld2	pile
falkd1	rapid
falkd2	valid
hjhgdf1	hunter
hjhgdf2	hunger
gfkdk1	trick
gfkdk2	brick
gld1	god
gld2	toe
hjg1	nut
hjg2	hug
shlfd1	shore
shlfd2	shove
gfafd1	grave
gfafd2	brave
lkg1	pig
lkg2	pit
sdafd1	scare
sdafd2	weave
slal1	slap
slal2	soap
glasg1	boast
glasg2	blast
hafd1	have
hafd2	hard
hafd3	yard
skgh1	with
skgh2	sign
skgh3	sigh
gjg1	but
gjg2	bug
gjg3	gut
gdg1	get
gdg2	bet
gdg3	beg
hdaf1	year
hdaf2	hear
hdaf3	near
gkfd1	give
gkfd2	bird
gkfd3	tire
glld1	good
glld2	gold
glld3	bold
ldg1	let
ldg2	leg
ldg3	pet
hdll1	help
hdll2	hell
hdll3	yell
gjfh1	turn
gjfh2	burn
gjfh3	bury
llah1	play
llah2	plan
llah3	loan
hlld1	hold
hlld2	hope
hlld3	hole
lah1	pay
lah2	lay
lah3	pan
sdg1	set
sdg2	wet
sdg3	web
gdsg1	best
gdsg2	test
gdsg3	text
fadd1	face
fadd2	race
fadd3	fade
skh1	win
skh2	sky
skh3	sin
gjh1	guy
gjh2	buy
gjh3	gun
fagd1	rate
fagd2	fate
fagd3	rage
dag1	eat
dag2	cat
dag3	cab
dash1	easy
dash2	cash
dash3	dawn
safd1	save
safd2	safe
safd3	wave
lkd1	lie
lkd2	pie
lkd3	lid
gag1	bag
gag2	bat
gag3	tag
gdhd1	tend
gdhd2	bend
gdhd3	gene
gfakh1	brain
gfakh2	train
gfakh3	grain
glhd1	bone
glhd2	bond
glhd3	tone
llll1	pool
llll2	poll
llll3	loop
gdaf1	bear
gdaf2	tear
gdaf3	gear
gah1	gay
gah2	ban
gah3	bay
llg1	lot
llg2	pot
llg3	log
llg4	opt
flld1	food
flld2	role
flld3	rope
flld4	fold
dafd1	care
dafd2	card
dafd3	dare
dafd4	cave
gfadd1	trade
gfadd2	grade
gfadd3	trace
gfadd4	grace
ghd	the
gd	be
ahd	and
a	a
kh	in
kg	it
k	i
ghag	that
flf	for
hlj	you
hd	he
dl	do
ghks	this
ag	at
sd	we
hks	his
fflj	from
gh	by
shd	she
as	as
shag	what
ghdkf	their
shl	who
kf	if
sljld	would
hdf	her
all	all
jakd	make
agljg	about
khls	know
skll	will
jl	up
lhd	one
gkjd	time
ghdfd	there
sl	so
ghkhk	think
shdh	when
shkdh	which
ghdj	them
sljd	some
jd	me
ldllld	people
khgl	into
sdd	see
hkj	him
dljld	could
ghah	than
lkkd	like
lghdf	other
kgs	its
ljf	our
gsl	two
ghdsd	these
sahg	want
lllk	look
fkfsg	first
alsl	also
gddajsd	because
jsd	use
hl	no
hdfd	here
ghkhg	thing
jahh	many
lhlh	only
ghlsd	those
fdfh	very
dfdh	even
gadk	back
ahh	any
sljah	woman
ghfljgh	through
dhkld	child
slfk	work
dlsh	down
afgdf	after
shljld	should
dall	call
slfld	world
lfdf	over
sdhlll	school
sgkll	still
gfh	try
ask	ask
hddd	need
fddl	feel
ghfdd	three
hdfdf	never
gddljd	become
gdgsddh	between
hkgh	high
fdallh	really
sljdghkhg	something
jlsg	most
ahlghdf	another
jjdh	much
fajklh	family
lsh	own
ldafd	leave
lld	old
shkld	while
jdah	mean
kddl	keep
sgjddhg	student
sajd	same
gfljl	group
gdgkh	begin
sddj	seem
dljhgfh	country
galk	talk
shdfd	where
lflgldj	problem
dfdfh	every
sgafg	start
hahd	hand
jkghg	might
ajdfkdah	american
lafg	part
agakhsg	against
lladd	place
sjdh	such
agakh	again
fds	few
dljlahh	company
shsgdj	system
dadh	each
lflgfaj	program
ajdsgklh	question
djfkhg	during
glfdfhjdhg	government
sjall	small
hjjgdf	number
lff	off
alsahs	always
hkghg	night
jf	mr
llkhg	point
gdlkdfd	believe
gldah	today
gfkhg	bring
halldh	happen
skghljg	without
gdflfd	before
lafgd	large
jkllklh	million
hljd	home
jhddf	under
sagdf	water
fllj	room
sfkgd	write
jlghdf	mother
afda	area
hagklhal	national
jlhdh	money
sglfh	story
hljhg	young
fadg	fact
jlhgh	month
dkffdfdhg	different
sgjdh	study
gllk	book
jlg	job
slfd	word
ghljgh	though
gjskhdss	business
kssjd	issue
kkhd	kind
fljf	four
hdad	head
faf	far
gladk	black
llhg	long
glgh	both
lkggld	little
hljsd	house
skhdd	since
lflfkdd	provide
sdffkdd	service
afljhd	around
ffkdhd	friend
kjllfgahg	important
skg	sit
asah	away
jhgkl	until
gajd	game
lfgdh	often
lllkgkdal	political
ajlhg	among
dfdf	ever
sgahd	stand
gad	bad
hlsdfdf	however
jdjgdf	member
las	law
jddg	meet
dkgh	city
aljlsg	almost
khdljdd	include
dlhgkhjd	continue
lagdf	later
dljjjhkgh	community
hajd	name
lhdd	once
shkgd	white
ldasg	least
lfdskddhg	president
ldafh	learn
fdal	real
dhahgd	change
jkhjgd	minute
sdfdfal	several
kdda	idea
kkd	kid
gldh	body
khflfjagklh	information
hlghkhg	nothing
agl	ago
ldad	lead
sldkal	social
jhddfsgahd	understand
shdghdf	whether
sagdh	watch
glgdghdf	together
flllls	follow
lafdhg	parent
sgll	stop
ahhghkhg	anything
dfdagd	create
ljglkd	public
alfdadh	already
sldak	speak
lghdfs	others
fdad	read
ldfdl	level
allls	allow
add	add
lffkdd	office
sldhd	spend
dllf	door
hdalgh	health
ldfslh	person
afg	art
sjfd	sure
saf	war
hksglfh	history
lafgh	party
skghkh	within
gfls	grow
fdsjlg	result
lldh	open
jlfhkhg	morning
salk	walk
fdaslh	reason
lls	low
fdsdafdh	research
gkfl	girl
daflh	early
jljdhg	moment
hkjsdlf	himself
akf	air
gdadhdf	teacher
flfdd	force
lffdf	offer
dhljgh	enough
ddjdagklh	education
adflss	across
alghljgh	although
fdjdjgdf	remember
sddlhd	second
jahgd	maybe
glsafd	toward
agld	able
agd	age
lllkdh	policy
dfdfhghkhg	everything
llfd	love
lflddss	process
jjskd	music
khdljdkhg	including
dlhskddf	consider
alldaf	appear
adgjallh	actually
lflgaglh	probably
hjjah	human
sakg	wait
sdffd	serve
jafkdg	market
dkd	die
sdhd	send
dslddg	expect
sdhsd	sense
gjkld	build
sgah	stay
fall	fall
hagklh	nation
djg	cut
dllldgd	college
khgdfdsg	interest
ddagh	death
dljfsd	course
sljdlhd	someone
dsldfkdhdd	experience
gdhkhd	behind
lldal	local
kkll	kill
sks	six
fdjakh	remain
dffddg	effect
hdah	yeah
sjggdsg	suggest
dlass	class
dlhgfll	control
faksd	raise
ldfhals	perhaps
fkdld	field
lass	pass
flfjdf	former
jajlf	major
sljdgkjds	sometimes
fdajkfd	require
allhg	along
ddfdllljdhg	development
ghdjsdlfds	themselves
fdllfg	report
gdggdf	better
ddlhljkd	economic
dfflfg	effort
dddkdd	decide
sgflhg	strong
llsskgld	possible
hdafg	heart
dfjg	drug
ldaddf	leader
lkghg	light
flkdd	voice
shlld	whole
lllkdd	police
fkhallh	finally
ljll	pull
fdgjfh	return
ffdd	free
jklkgafh	military
ldss	less
addlfdkhg	according
dddksklh	decision
dsllakh	explain
ddfdlll	develop
fkds	view
fdlagklhshkl	relationship
daffh	carry
glsh	town
flad	road
dfkfd	drive
afj	arm
gfjd	true
fdddfal	federal
gfdak	break
dkffdfdhdd	difference
ghahk	thank
fdddkfd	receive
faljd	value
khgdfhagklhal	international
gjkldkhg	building
adgklh	action
fjll	full
jlddl	model
jlkh	join
sdaslh	season
sldkdgh	society
dkfddglf	director
llskgklh	position
llahdf	player
agfdd	agree
dslddkallh	especially
fddlfd	record
lkdk	pick
sdaf	wear
laldf	paper
slddkal	special
sladd	space
gfljhd	ground
flfj	form
sjlllfg	support
dfdhg	event
lffkdkal	official
shlsd	whose
jaggdf	matter
dfdfhlhd	everyone
ddhgdf	center
dljlld	couple
skgd	site
lfljddg	project
hkg	hit
gasd	base
adgkfkgh	activity
sgaf	star
gagld	table
dljfg	court
lfldjdd	produce
half	half
skgjagklh	situation
dlsg	cost
khdjsgfh	industry
fkgjfd	figure
sgfddg	street
kjagd	image
kgsdlf	itself
lhlhd	phone
dkghdf	either
daga	data
dlfdf	cover
ajkgd	quite
lkdgjfd	picture
dldaf	clear
lfadgkdd	practice
lkddd	piece
fdddhg	recent
ddsdfkgd	describe
lfldjdg	product
dldglf	doctor
sall	wall
lagkdhg	patient
slfkdf	worker
hdss	news
jlfkd	movie
ddfgakh	certain
hlfgh	north
ldfslhal	personal
skjllh	simply
ghkfd	third
gddhhlllgh	technology
dagdh	catch
sgdl	step
dljljgdf	computer
ghld	type
aggdhgklh	attention
dfas	draw
fklj	film
fdljglkdah	republican
gfdd	tree
sljfdd	source
hdaflh	nearly
lfgahkaagklh	organization
dhllsd	choose
dajsd	cause
hakf	hair
ddhgjfh	century
dfkddhdd	evidence
skhdls	window
dkffkdjlg	difficult
lksgdh	listen
sllh	soon
djlgjfd	culture
gkllklh	billion
dhahdd	chance
gflghdf	brother
dhdfgh	energy
ldfkld	period
sjjjdf	summer
fdalkad	realize
hjhdfdd	hundred
afaklagld	available
llahg	plant
lkkdlh	likely
llllfgjhkgh	opportunity
gdfj	term
shlfg	short
ldggdf	letter
dlhdkgklh	condition
dhlkdd	choice
skhgld	single
fjld	rule
dajghgdf	daughter
adjkhksgfagklh	administration
sljgh	south
hjsgahd	husband
dlhgfdss	congress
flllf	floor
dajlakgh	campaign
jagdfkal	material
llljlagklh	population
ddlhljh	economy
jddkdal	medical
hlslkgal	hospital
dhjfdh	church
dllsd	close
ghljsahd	thousand
fksk	risk
djffdhg	current
fjgjfd	future
sflhg	wrong
khfllfd	involve
ddfdhsd	defense
ahhlhd	anyone
khdfdasd	increase
sddjfkgh	security
jhsdlf	myself
ddfgakhlh	certainly
sdsg	west
sllfg	sport
glafd	board
ldf	per
sjgjddg	subject
lffkddf	officer
lfkfagd	private
fdsg	rest
gdhafklf	behavior
ddal	deal
ldfflfjahdd	performance
ghfls	throw
ajkdklh	quickly
glal	goal
lfddf	order
ajghlf	author
fkll	fill
fdlfdsdhg	represent
fldjs	focus
flfdkgh	foreign
gllld	blood
agdhdh	agency
ljsh	push
hagjfd	nature
dlllf	color
fdddhglh	recently
fddjdd	reduce
hlgd	note
jlfdjdhg	movement
dhgdf	enter
shafd	share
dljjlh	common
lllf	poor
hagjfal	natural
dlhddfh	concern
sdfkds	series
skghkfkdahg	significant
skjklaf	similar
lahgjagd	language
jsjallh	usually
fdsllhsd	response
ddad	dead
fksd	rise
ahkjal	animal
fadglf	factor
dddadd	decade
afgkdld	article
shllg	shoot
sdfdh	seven
afgksg	artist
sddhd	scene
sgldk	stock
dafddf	career
ddslkgd	despite
ddhgfal	central
dkghg	eight
ghjs	thus
gfdagjdhg	treatment
gdhlhd	beyond
hallh	happy
dsadglh	exactly
lflgddg	protect
allfladh	approach
skad	size
fjhd	fund
sdfkljs	serious
lddjf	occur
jddka	media
ghljghg	thought
lksg	list
khdkfkdjal	individual
skjlld	simple
ajalkgh	quality
lfdssjfd	pressure
adddlg	accept
ahssdf	answer
fdsljfdd	resource
kddhgkfh	identify
ldfg	left
jddgkhg	meeting
ddgdfjkhd	determine
lfdlafd	prepare
dksdasd	disease
shagdfdf	whatever
sjdddss	success
afgjd	argue
djl	cup
lafgkdjlaflh	particularly
ajljhg	amount
agklkgh	ability
sgaff	staff
fddlghkad	recognize
khdkdagd	indicate
dhafadgdf	character
gflsgh	growth
llss	loss
ddgfdd	degree
slhddf	wonder
aggadk	attack
hdfsdlf	herself
fdgklh	region
gdldfksklh	television
gf	tv
gfakhkhg	training
lfdggh	pretty
dlddgklh	election
dfdfhgldh	everybody
lhhskdal	physical
gdhdfal	general
fddlkhg	feeling
sgahdafd	standard
jdssagd	message
ljgskdd	outside
affkfd	arrive
ahalhsks	analysis
gdhdfkg	benefit
sds	sex
flfsafd	forward
lashdf	lawyer
lfdsdhg	present
sddgklh	section
dhfkflhjdhgal	environmental
glass	glass
skkll	skill
sksgdf	sister
lj	pm
lflfdsslf	professor
lldfagklh	operation
fkhahdkal	financial
dfkjd	crime
lk	ok
dljlafd	compare
ajghlfkgh	authority
jkss	miss
ddskgh	design
adg	act
gdh	ten
khlslddgd	knowledge
sgagklh	station
gljd	blue
sgfagdgh	strategy
dldaflh	clearly
dksdjss	discuss
khdddd	indeed
gfjgh	truth
slhg	song
dsajlld	example
ddjldfagkd	democratic
dhfkflhjdhg	environment
dafk	dark
fafkljs	various
lajgh	laugh
gjdss	guess
dsddjgkfd	executive
lflfd	prove
hahg	hang
dhgkfd	entire
fldk	rock
flfgdg	forget
dlakj	claim
fdjlfd	remove
jahagdf	manager
dhjlh	enjoy
hdgslfk	network
ldgal	legal
fdlkgkljs	religious
fkhal	final
jakh	main
sdkdhdd	science
gfddh	green
jdjlfh	memory
aglfd	above
sdag	seat
ddll	cell
dsgaglksh	establish
gfkal	trial
dsldfg	expert
slfkhg	spring
fkfj	firm
ddjldfag	democrat
fadkl	radio
fkskg	visit
jahagdjdhg	management
aflkd	avoid
kjagkhd	imagine
glhkghg	tonight
hjgd	huge
fkhksh	finish
hljfsdlf	yourself
ghdlfh	theory
kjladg	impact
fdsllhd	respond
sgagdjdhg	statement
jakhgakh	maintain
dhafgd	charge
llljlaf	popular
gfadkgklhal	traditional
lhgl	onto
fdfdal	reveal
dkfddgklh	direction
sdallh	weapon
djlllhdd	employee
djlgjfal	cultural
dlhgakh	contain
ldadd	peace
lakh	pain
alllh	apply
jdasjfd	measure
flh	fly
khgdffkds	interview
jahagd	manage
dhakf	chair
fksh	fish
lafgkdjlaf	particular
dajdfa	camera
sgfjdgjfd	structure
lllkgkds	politics
ldfflfj	perform
sdkghg	weight
sjdddhlh	suddenly
dksdlfdf	discover
dahdkdagd	candidate
lfldjdgklh	production
dfdhkhg	evening
affddg	affect
khskdd	inside
dlhfdfdhdd	conference
jhkg	unit
sghld	style
adjlg	adult
fahgd	range
jdhgklh	mention
dddl	deep
ddgd	edge
slddkfkd	specific
sfkgdf	writer
gfljgld	trouble
hdddssafh	necessary
ghfljghljg	throughout
dhalldhgd	challenge
shljlddf	shoulder
khsgkgjgklh	institution
jkddld	middle
sda	sea
gaf	bar
gdajgkfjl	beautiful
lflldfgh	property
khsgdad	instead
kjlflfd	improve
sgjff	stuff
ddgakl	detail
jdghld	method
sljdgldh	somebody
jagaakhd	magazine
hlgdl	hotel
slldkdf	soldier
fdflddg	reflect
hdafh	heavy
sdsjal	sexual
jaffkagd	marriage
gljgh	tough
sjffadd	surface
ljfllsd	purpose
dsksg	exist
laggdfh	pattern
shlj	whom
skkh	skin
agdhg	agent
lshdf	owner
jadhkhd	machine
ahdad	ahead
gdhdfagklh	generation
dljjdfdkal	commercial
addfdss	address
kgdj	item
fdalkgh	reality
jfs	mrs
gdag	beat
fklldhdd	violence
glgal	total
khfdsgjdhg	investment
dksdjssklh	discussion
fkhgdf	finger
gafddh	garden
hlgkdd	notice
dlllddgklh	collection
jlddfh	modern
gask	task
lafghdf	partner
llskgkfd	positive
dkfkl	civil
kkgdhdh	kitchen
dlhsjjdf	consumer
shlg	shot
gjdgdg	budget
sksh	wish
lakhgkhg	painting
sdkdhgksg	scientist
agfddjdhg	agreement
dalkgal	capital
jljgh	mouth
hlf	nor
fkdgkj	victim
hdsslaldf	newspaper
ghfdag	threat
fdsllhskgklkgh	responsibility
sjkld	smile
agglfhdh	attorney
sdlfd	score
addljhg	account
khgdfdsgkhg	interesting
ajdkdhdd	audience
fkdh	rich
dkhhdf	dinner
flgd	vote
sdsgdfh	western
fdlagd	relate
gfafdl	travel
ddgagd	debate
lfdfdhg	prevent
dkgkadh	citizen
jajlfkgh	majority
hlhd	none
fflhg	front
glfh	born
adjkg	admit
sdhklf	senior
assjjd	assume
kdh	key
lflfdssklhal	professional
jkssklh	mission
allhd	alone
djsgljdf	customer
sjffdf	suffer
sldddh	speech
sjdddssfjl	successful
llgklh	option
lafgkdklahg	participant
sljghdfh	southern
ffdsh	fresh
dfdhgjallh	eventually
flfdsg	forest
fkddl	video
gllgal	global
sdhagd	senate
fdflfj	reform
adddss	access
fdsgajfahg	restaurant
jjdgd	judge
ljglksh	publish
fdlagklh	relation
fdldasd	release
llkhklh	opinion
dfddkg	credit
dfkgkdal	critical
dlfhdf	corner
dlhddfhdd	concerned
fddall	recall
fdfsklh	version
sgafd	stare
safdgh	safety
dffddgkfd	effective
hdkghglfhlld	neighborhood
lfkgkhal	original
gflll	troop
khdljd	income
dkfddglh	directly
hjfg	hurt
slddkds	species
kjjddkagdlh	immediately
gfadk	track
gaskd	basic
sgfkkd	strike
ffdddlj	freedom
agslljgdlh	absolutely
llahd	plane
hlgldh	nobody
adhkdfd	achieve
lgjddg	object
aggkgjdd	attitude
laglf	labor
dlhddlg	concept
dlkdhg	client
llsdffjl	powerful
ldffddg	perfect
hkhd	nine
ghdfdflfd	therefore
dlhdjdg	conduct
ahhljhdd	announce
dlhfdfsagklh	conversation
dsajkhd	examine
gljdh	touch
lldasd	please
aggdhd	attend
dljlldgdlh	completely
fafkdgh	variety
slddl	sleep
khfllfdd	involved
khfdsgkgagklh	investigation
hjdldaf	nuclear
fdsdafdhdf	researcher
lfdss	press
dlhflkdg	conflict
slkfkg	spirit
fdlladd	replace
gfkgksh	british
dhdljfagd	encourage
afgjjdhg	argument
dajl	camp
fdagjfd	feature
afgdfhllh	afternoon
aj	am
sddkdhd	weekend
llsskgklkgh	possibility
khsjfahdd	insurance
ddlafgjdhg	department
gaggld	battle
gdgkhhkhg	beginning
gdhdfallh	generally
affkdah	african
dfksks	crisis
dljlldgd	complete
sgkdk	stick
ddfkhd	define
dasklh	easily
dldjdhg	element
fksklh	vision
sgagjs	status
hlfjal	normal
dhkhdsd	chinese
slljgklh	solution
sglhd	stone
sllslh	slowly
sdald	scale
jhkfdfskgh	university
khgfldjdd	introduce
dfkfdf	driver
aggdjlg	attempt
lafk	park
kdd	ice
dfkhk	drink
sjh	sun
dksgahdd	distance
hahdld	handle
gfjdk	truck
jljhgakh	mountain
sjffdh	survey
sjlllsdd	supposed
gfadkgklh	tradition
slfkdg	soviet
fdfjsd	refuse
salds	sales
dljjjhkdagklh	communication
sdfddh	screen
gakh	gain
fdskddhg	resident
dljg	club
fafj	farm
llgdhgkal	potential
djflldah	european
lfdsdhdd	presence
khddldhddhg	independent
dksgfkdg	district
fdaddf	reader
dlhgfadg	contract
dflsd	crowd
dhfksgkah	christian
dslfdss	express
alafgjdhg	apartment
skllkhg	willing
sgfdhggh	strength
lfdfkljs	previous
gahd	band
lgfkljslh	obviously
hlfsd	horse
khgdfdsgdd	interested
gafgdg	target
lfkslh	prison
gjafd	guard
gdfjs	terms
ddjahd	demand
fdllfgdf	reporter
ddlkfdf	deliver
fdhkdld	vehicle
lgsdffd	observe
flkghg	flight
fadklkgh	facility
jhddfsgahdkhg	understanding
afdfagd	average
djdfgd	emerge
adfahgagd	advantage
ajkdk	quick
ldaddfshkl	leadership
dafh	earn
lljhd	pound
gasks	basis
gfkghg	bright
lldfagd	operate
gjdsg	guest
sajlld	sample
dlhgfkgjgd	contribute
gkhh	tiny
glldk	block
lflgddgklh	protection
sdggld	settle
fddd	feed
dlllddg	collect
addkgklhal	additional
hkghlh	highly
kddhgkgh	identity
jlsglh	mostly
ldsslh	lesson
fakgh	faith
fkfdf	river
lfljlgd	promote
lkfkhg	living
dljhg	count
jhldss	unless
jaffh	marry
gljlffls	tomorrow
gddhhkajd	technique
lagh	path
shll	shop
fllk	folk
lfkhdklld	principle
sjffkfd	survive
lkfg	lift
glfddf	border
dljldgkgklh	competition
jjjl	jump
gaghdf	gather
lkjkg	limit
dajkljdhg	equipment
slfgh	worth
assldkagd	associate
dfkgkd	critic
safj	warm
aslddg	aspect
khsksg	insist
fakljfd	failure
ahhjal	annual
ffdhdh	french
dhfksgjas	christmas
dljjdhg	comment
fdsllhskgld	responsible
affakf	affair
lfldddjfd	procedure
fdgjlaf	regular
slfdad	spread
dhakfjah	chairman
gasdgall	baseball
kghlfd	ignore
dgg	egg
gdlkdf	belief
ddjlhsgfagd	demonstrate
ahhgldh	anybody
jjfddf	murder
gkfg	gift
fdlkgklh	religion
fdfkds	review
ddkglf	editor
dhgagd	engage
dlffdd	coffee
dldjjdhg	document
slddd	speed
dflss	cross
khfljdhdd	influence
ahhsah	anyway
ghfdagdh	threaten
dljjkg	commit
fdjald	female
hljgh	youth
affakd	afraid
ajafgdf	quarter
gadkgfljhd	background
hagkfd	native
gflad	broad
slhddffjl	wonderful
ddhh	deny
allafdhglh	apparently
slkghglh	slightly
fdadgklh	reaction
gskdd	twice
sjkg	suit
ldfslddgkfd	perspective
gflskhg	growing
glls	blow
dlhsgfjdgklh	construction
khgdllkgdhdd	intelligence
ddsgflh	destroy
dllk	cook
dlhhddgklh	connection
shld	shoe
dljjkggdd	committee
hdh	hey
jksgakd	mistake
lldagklh	location
dllghds	clothes
khdkah	indian
ajkdg	quiet
dfdss	dress
lfljksd	promise
hdkghglf	neighbor
fjhdgklh	function
adgkfd	active
dsgdhd	extend
dhkdf	chief
dljgkhd	combine
gdlls	below
flgdf	voter
ldafhkhg	learning
gjs	bus
dahgdfljs	dangerous
fdjkhd	remind
jlfal	moral
jhkgdd	united
dagdglfh	category
fdlagkfdlh	relatively
fkdglfh	victory
adaddjkd	academic
khgdfhdg	internet
hdalghh	healthy
hdgagkfd	negative
fllllskhg	following
hksglfkdal	historical
jddkdkhd	medicine
gljf	tour
ddldhd	depend
lhlgl	photo
fkhdkhg	finding
gfag	grab
dkfddg	direct
dlassfllj	classroom
dlhgadg	contact
jjsgkdd	justice
lafgkdklagd	participate
daklh	daily
fakf	fair
lakf	pair
fajljs	famous
dsdfdksd	exercise
khdd	knee
fllsdf	flower
hkfd	hire
fajklkaf	familiar
allfllfkagd	appropriate
sjlllh	supply
fjllh	fully
adglf	actor
gkfgh	birth
sdafdh	search
ddjldfadh	democracy
dasgdfh	eastern
lfkjafh	primary
hdsgdfdah	yesterday
dkfdld	circle
ddfkdd	device
lflgfdss	progress
glgglj	bottom
kslahd	island
dsdhahgd	exchange
dldah	clean
sgjdkl	studio
ladh	lady
dllldagjd	colleague
alllkdagklh	application
hddk	neck
ldah	lean
dajagd	damage
llasgkd	plastic
llagd	plate
hagd	hate
lghdfsksd	otherwise
sfkgkhg	writing
jald	male
alkfd	alive
dslfdssklh	expression
fllggall	football
khgdhd	intend
dhkdkdh	chicken
afjh	army
agjsd	abuse
ghdagdf	theater
shjg	shut
jal	map
dsgfa	extra
sdssklh	session
dahgdf	danger
sdldljd	welcome
dljdsgkd	domestic
llgs	lots
lkgdfagjfd	literature
fakh	rain
ddskfd	desire
assdssjdhg	assessment
khjjfh	injury
fdslddg	respect
hlfghdfh	northern
hld	nod
lakhg	paint
fjdl	fuel
ldaf	leaf
fjsskah	russian
khsgfjdgklh	instruction
dlkjg	climb
ssddg	sweet
dhgkhd	engine
fljfgh	fourth
salg	salt
dslahd	expand
kjllfgahdd	importance
jdgal	metal
gkdkdg	ticket
slfgsafd	software
dksalldaf	disappear
dlfllfagd	corporate
sgfahgd	strange
fdadkhg	reading
jfgah	urban
jdhgal	mental
khdfdaskhglh	increasingly
ddjdagklhal	educational
sljdshdfd	somewhere
fafjdf	farmer
sjgaf	sugar
llahdg	planet
faflfkgd	favorite
dslllfd	explore
lggakh	obtain
dhdjh	enemy
gfdagdsg	greatest
dljllds	complex
sjffljhd	surround
aghldgd	athlete
khfkgd	invite
fdldag	repeat
dafdfjllh	carefully
sdkdhgkfkd	scientific
kjllsskgld	impossible
lahdl	panel
jdahkhg	meaning
jlj	mom
jaffkdd	married
khsgfjjdhg	instrument
lfddkdg	predict
sdaghdf	weather
lfdskddhgkal	presidential
djlgklhal	emotional
dljjkgjdhg	commitment
sjlfdjd	supreme
lldkdg	pocket
ghkh	thin
gdjldfagjfd	temperature
sjflfksd	surprise
lflllsal	proposal
dlhsdajdhdd	consequence
skghg	sight
galahdd	balance
adllg	adopt
jkhlfkgh	minority
sgfakghg	straight
dlhhddg	connect
slfks	works
gdadhkhg	teaching
gdllhg	belong
akd	aid
adfkdd	advice
lkah	okay
lhlglgfalh	photograph
djlgh	empty
fdgklhal	regional
gfakl	trail
hlfdl	novel
dldd	code
sljdhls	somehow
lfgahkad	organize
jjfh	jury
gfdasg	breast
kfaak	iraqi
adkhlslddgd	acknowledge
ghdjd	theme
sglfj	storm
jhklh	union
ddsk	desk
ghahks	thanks
ffjkg	fruit
dsldhskfd	expensive
hdllls	yellow
dlhdljsklh	conclusion
lfkjd	prime
shadls	shadow
sgfjggld	struggle
dlhdljdd	conclude
ahalhsg	analyst
dahdd	dance
fdgjlagklh	regulation
gdkhg	being
fkhg	ring
lafgdlh	largely
fdfdhjd	revenue
jafk	mark
lldagd	locate
dljhgh	county
alldafahdd	appearance
ladkagd	package
dkffkdjlgh	difficulty
gfkdgd	bridge
fddljjdhd	recommend
lgfkljs	obvious
gaskdallh	basically
d-jakl	e-mail
gdhdfagd	generate
ahhjlfd	anymore
lflllsd	propose
ghkhkkhg	thinking
llsskglh	possibly
gfdhd	trend
fkskglf	visitor
djffdhglh	currently
dljflfgagld	comfortable
khfdsglf	investor
lflfkg	profit
ahgfh	angry
dfds	crew
addkddhg	accident
jdal	meal
hdafkhg	hearing
gfaffkd	traffic
jjsdld	muscle
hlgklh	notion
dalgjfd	capture
lfdfdf	prefer
gfjlh	truly
dafgh	earth
jalahdsd	japanese
dhdsg	chest
ghkdk	thick
jjsdjj	museum
gdajgh	beauty
djdfgdhdh	emergency
jhkajd	unique
khgdfhal	internal
dghhkd	ethnic
sgfdss	stress
dlhgdhg	content
sdlddg	select
hlsd	nose
dddlafd	declare
allfddkagd	appreciate
adgjal	actual
glggld	bottle
hafdlh	hardly
sdggkhg	setting
lajhdh	launch
fkld	file
skdk	sick
ljgdljd	outcome
ad	ad
ddfdhd	defend
djgh	duty
shddg	sheet
ljghg	ought
dhsjfd	ensure
daghllkd	catholic
dsgfdjdlh	extremely
dsgdhg	extent
dljllhdhg	component
jks	mix
llhg-gdfj	long-term
slls	slow
dlhgfasg	contrast
alhd	zone
akfllfg	airport
gflsh	brown
lkllg	pilot
safh	warn
jlgkjagdlh	ultimately
dlhgfkgjgklh	contribution
daladkgh	capacity
ljfsdlfds	ourselves
dsgagd	estate
gjkdd	guide
dkfdjjsgahdd	circumstance
dhglksh	english
lllkgkdkah	politician
sgdal	steal
ljfsjd	pursue
ldfddhgagd	percentage
jdag	meat
fjhhh	funny
hdkghdf	neither
sjfgdfh	surgery
dlffddg	correct
jdsksh	jewish
glajd	blame
dsgkjagd	estimate
gaskdggall	basketball
gllf	golf
khfdsgkgagd	investigate
dfaah	crazy
skghkfkdahglh	significantly
dhakh	chain
gfahdh	branch
dljgkhagklh	combination
ffdajdhglh	frequently
glfdfhlf	governor
fdlkdf	relief
jsdf	user
dad	dad
kkdk	kick
jahhdf	manner
ahdkdhg	ancient
skldhdd	silence
fagkhg	rating
gllddh	golden
jlgklh	motion
gdfjah	german
sllfd	solve
lahdsdald	landscape
jsdd	used
glsl	bowl
dajal	equal
ghlkdal	typical
dsddlg	except
dlhsdffagkfd	conservative
dlkjkhagd	eliminate
hlsg	host
hall	hall
gfjsg	trust
lddah	ocean
fls	row
lfldjddf	producer
afflfd	afford
jdahshkld	meanwhile
fdgkjd	regime
dkfksklh	division
dlhfkfj	confirm
fks	fix
alldal	appeal
jkfflf	mirror
sjafg	smart
ldhggh	length
dhgkfdlh	entirely
fdlh	rely
gllkd	topic
dljllakh	complain
fafkagld	variable
gdldlhlhd	telephone
ldfddlgklh	perception
aggfadg	attract
dlhfkddhdd	confidence
gddfllj	bedroom
sddfdg	secret
ddgg	debt
hjfsd	nurse
dlfdfagd	coverage
llllskgklh	opposition
askdd	aside
ahhshdfd	anywhere
lldasjfd	pleasure
jasgdf	master
dfa	era
fdajkfdjdhg	requirement
dslddgagklh	expectation
sdlafagd	separate
sljdshag	somewhat
lljf	pour
sgkf	stir
jjdgjdhg	judgment
fdfdfdhdd	reference
dljgg	doubt
gfahg	grant
sdfkljslh	seriously
jkhksgdf	minister
glgallh	totally
hdfl	hero
khdjsgfkal	industrial
dlljd	cloud
sgfdgdh	stretch
skhhdf	winner
flljjd	volume
sjflfksdd	surprised
fashklh	fashion
ldlldf	pepper
khgdffdhgklh	intervention
dllh	copy
gkl	tip
dhdal	cheap
akj	aim
dkgd	cite
sdlfafd	welfare
fdgdgagld	vegetable
dksh	dish
kjlflfdjdhg	improvement
dfdfhshdfd	everywhere
lldhkhg	opening
lfdfall	overall
dkfkdd	divide
khkgkal	initial
gdffkgld	terrible
llllsd	oppose
dlhgdjllfafh	contemporary
fljgd	route
jjlgklld	multiple
dssdhgkal	essential
ldagjd	league
dfkjkhal	criminal
dafdfjl	careful
jlldf	upper
fjsh	rush
hdddssafklh	necessarily
slddkfkdallh	specifically
gkfdd	tired
djlllh	employ
hllkdah	holiday
fdslljgklh	resolution
hljsdhlld	household
fdsdf	fewer
aglfgklh	abortion
alafg	apart
skghdss	witness
jagdh	match
gafdlh	barely
sddglf	sector
fdlfdsdhgagkfd	representative
gdhdagh	beneath
gdskdd	beside
khdkddhg	incident
lkjkgdd	limited
lfljd	proud
flls	flow
fadjlgh	faculty
khdfdasdd	increased
sasgd	waste
jdfdlh	merely
jass	mass
djlhaskad	emphasize
dsldfkjdhg	experiment
ddfkhkgdlh	definitely
gljg	bomb
dhlfjljs	enormous
lkgdfal	liberal
jasskfd	massive
dhgkhddf	engineer
dddlkhd	decline
khfdsg	invest
dagld	cable
glsafds	towards
dsllsd	expose
fjfal	rural
akds	aids
jds	jew
haffls	narrow
sddfdgafh	secretary
gagd	gate
sllkd	solid
hkll	hill
ghlkdallh	typically
hlksd	noise
gfass	grass
jhflfgjhagdlh	unfortunately
hag	hat
ldgkslagklh	legislation
sjddddd	succeed
ddldgfagd	celebrate
adhkdfdjdhg	achievement
fkshkhg	fishing
addjsd	accuse
jsdfjl	useful
fdjddg	reject
galdhg	talent
gasgd	taste
dhafadgdfksgkd	characteristic
jklk	milk
dsdald	escape
sdhgdhdd	sentence
jhjsjal	unusual
dllsdlh	closely
dlhfkhdd	convince
hdkghg	height
lhhskdkah	physician
assdss	assess
lldhgh	plenty
fkfgjallh	virtually
addkgklh	addition
shafl	sharp
dfdagkfd	creative
allflfd	approve
dsllahagklh	explanation
dajljs	campus
lflldf	proper
gjklgh	guilty
adajkfd	acquire
dljldgd	compete
gddhhkdal	technical
lljs	plus
kjjkgfahg	immigrant
sdak	weak
klldgal	illegal
hk	hi
algdfhagkfd	alternative
khgdfadgklh	interaction
dlljjh	column
ldfslhalkgh	personality
skghal	signal
djffkdjljj	curriculum
hlhlf	honor
lassdhgdf	passenger
assksgahdd	assistance
flfdfdf	forever
fdgafd	regard
ksfadlk	israeli
assldkagklh	association
gsdhgh	twenty
khldk	knock
sfal	wrap
dksllah	display
dfkgkdksj	criticism
assdg	asset
ddlfdssklh	depression
slkfkgjal	spiritual
jjskdal	musical
jljfhalksg	journalist
lfahdf	prayer
sjslddg	suspect
sdhllaf	scholar
safhkhg	warning
dlkjagd	climate
dhddsd	cheese
lgsdffagklh	observation
dhkldhlld	childhood
lahjdhg	payment
skf	sir
ldfjkg	permit
dkgafdggd	cigarette
ddfkhkgklh	definition
lfklfkgh	priority
gfdad	bread
dfdagklh	creation
gfadjagd	graduate
fdajdsg	request
djlgklh	emotion
sdfdaj	scream
dfajagkd	dramatic
jhkfdfsd	universe
dsddlldhg	excellent
dddllh	deeply
lflsddjglf	prosecutor
ljdkh	lucky
dfag	drag
akflkhd	airline
lkgfafh	library
agdhda	agenda
fddlfdf	recover
fadglfh	factory
sdlddgklh	selection
lfkjafklh	primarily
fllf	roof
jhagld	unable
dsldhsd	expense
khkgkagkfd	initiative
dkdg	diet
affdsg	arrest
fjhdkhg	funding
ghdfalh	therapy
sash	wash
sdhddjld	schedule
sad	sad
hljskhg	housing
ljfdhasd	purchase
dsksgkhg	existing
fdgafdkhg	regarding
shljg	shout
fdjakhkhg	remaining
fksjal	visual
fakflh	fairly
dhkl	chip
fklldhg	violent
skldhg	silent
sjlllsd	suppose
sdlf	self
gkkd	bike
gda	tea
ldfddkfd	perceive
dljlafkslh	comparison
sdggldjdhg	settlement
lahdf	layer
llahhkhg	planning
ddsdfklgklh	description
skddlh	widely
sdddkhg	wedding
khflfj	inform
llfgklh	portion
gdffkglfh	territory
kjjddkagd	immediate
llllhdhg	opponent
agahdlh	abandon
lakd	lake
gfahsflfj	transform
gdhsklh	tension
ldadkhg	leading
glghdf	bother
dlhsksg	consist
aldlhll	alcohol
dhagld	enable
safkhg	saving
ddsdfg	desert
shall	shall
dfflf	error
dll	cop
afag	arab
dljgld	double
sahd	sand
slahksh	spanish
lfkhg	print
lfdsdffd	preserve
lassagd	passage
flfjal	formal
gfahskgklh	transition
dsksgdhdd	existence
algjj	album
lafgkdklagklh	participation
affahgd	arrange
agjlslhdfd	atmosphere
jlkhg	joint
fdllh	reply
dhdld	cycle
llllskgd	opposite
lldk	lock
ddsdffd	deserve
dlhsksgdhg	consistent
fdsksgahdd	resistance
dksdlfdfh	discovery
dsllsjfd	exposure
sgfdaj	stream
sald	sale
hdlll	hello
dlalkgklh	coalition
khkfd	knife
fdsllfd	resolve
fadkal	racial
lhasd	phase
jlkd	joke
dlag	coat
jdskdah	mexican
shjlglj	symptom
jahjfadgjfdf	manufacturer
lhkllsllhh	philosophy
llgagl	potato
fljhdagklh	foundation
ajlgd	quote
lhlkhd	online
hdglgkagklh	negotiation
jfgd	urge
lddasklh	occasion
djsg	dust
gfdaghd	breathe
dlddg	elect
khfdsgkgaglf	investigator
jadkdg	jacket
glad	glad
lfdkhafh	ordinary
fddjdgklh	reduction
fafdlh	rarely
sjkdkdd	suicide
hjjdfljs	numerous
sjgsgahdd	substance
dksdkllkhd	discipline
dlsdshdfd	elsewhere
kflh	iron
lfadgkdal	practical
jlfdlfdf	moreover
lassklh	passion
flljhgddf	volunteer
kjlldjdhg	implement
dssdhgkallh	essentially
dhflfddjdhg	enforcement
fs	vs
sajdd	sauce
khddldhddhdd	independence
jafkdgkhg	marketing
lfkdsg	priest
ajaakhg	amazing
khgdhsd	intense
adfahdd	advance
djlllhdf	employer
shldk	shock
khslkfd	inspire
adjjsg	adjust
fdgkfd	retire
fkskgld	visible
kkss	kiss
kllhdss	illness
dal	cap
hagkg	habit
dljldgkgkfd	competitive
jjkdd	juice
dlhgfdssklhal	congressional
khfllfdjdhg	involvement
dljkhagd	dominate
lfdfkljslh	previously
shdhdfdf	whenever
gfahsfdf	transfer
ahalhad	analyze
aggadh	attach
dksasgdf	disaster
lafkkhg	parking
lflslddg	prospect
dljllakhg	complaint
dhajlklhshkl	championship
fjhdajdhgal	fundamental
sdfdfd	severe
dhhahdd	enhance
jhsgdfh	mystery
kjllsd	impose
llfdfgh	poverty
dhgfh	entry
sldhdkhg	spending
kkhg	king
dfaljagd	evaluate
shjgll	symbol
jakdf	maker
jlld	mood
addljllksh	accomplish
djlhasks	emphasis
klljsgfagd	illustrate
jlhkglf	monitor
askah	asian
dhgdfgakhjdhg	entertainment
gdah	bean
dfaljagklh	evaluation
dfdagjfd	creature
dljjahddf	commander
dkgkgal	digital
affahgdjdhg	arrangement
dlhddhgfagd	concentrate
jsjal	usual
ahgdf	anger
lshdhlllgkdal	psychological
hdafklh	heavily
ldak	peak
allflskjagdlh	approximately
khdfdaskhg	increasing
dkslfddf	disorder
jksskld	missile
dajallh	equally
fafh	vary
dksgfkgjgklh	distribution
gfahsllfgagklh	transportation
gskh	twin
dljjahd	command
dljjkssklh	commission
khgdflfdgagklh	interpretation
gfdakfasg	breakfast
sgflhglh	strongly
dhgkhddfkhg	engineering
ljdk	luck
sl-dalldd	so-called
dlhsgahg	constant
dlkhkd	clinic
fdgdfah	veteran
sjdll	smell
gagldslllh	tablespoon
dalagld	capable
hdffljs	nervous
gljfksg	tourist
dfjdkal	crucial
lfah	pray
gljagl	tomato
dsddlgklh	exception
gjggdf	butter
ddfkdkg	deficit
gaghfllj	bathroom
lgjddgkfd	objective
dlddgflhkd	electronic
allh	ally
jljfhdh	journey
fdljgagklh	reputation
jksgjfd	mixture
sjfdlh	surely
glsdf	tower
sjlkd	smoke
dlhfflhg	confront
ljfd	pure
glahdd	glance
dkjdhsklh	dimension
lfkslhdf	prisoner
fdllls	fellow
sjllgh	smooth
hdafgh	nearby
lddf	peer
ddskghdf	designer
ldfslhhdl	personnel
ddjdaglf	educator
fdlagkfd	relative
kjjkgfagklh	immigration
gdlg	belt
gdaslllh	teaspoon
gkfghdah	birthday
kjllkdagklh	implication
ldffddglh	perfectly
dlasg	coast
sjlllfgdf	supporter
addljlahh	accompany
sklfdf	silver
gddhagdf	teenager
fddlghkgklh	recognition
fdgkfdjdhg	retirement
fddlfdfh	recovery
shksldf	whisper
gdhgldjah	gentleman
dlfh	corn
khhdf	inner
jjhklf	junior
ghflag	throat
salafh	salary
sskhg	swing
lgsdffdf	observer
ljglkdagklh	publication
dkg	dig
ldfjahdhg	permanent
lhdhljdhlh	phenomenon
ahskdgh	anxiety
jhlkkd	unlike
lkgdfallh	literally
fdsksg	resist
dlhfdhgklh	convention
djgfadd	embrace
assksg	assist
dshkgkgklh	exhibition
dlhsgfjdg	construct
fkdsdf	viewer
dlhsjlgahg	consultant
adjkhksgfaglf	administrator
lddasklhallh	occasionally
jahlf	mayor
dlhskddfagklh	consideration
ddl	ceo
sddjfd	secure
hksglfkd	historic
lldj	poem
gfahdjlghdf	grandmother
gkhd	bind
dlhsgahglh	constantly
dhgdflfksd	enterprise
faflf	favor
gdsgkhg	testing
sgljadh	stomach
allafdhg	apparent
sdkgh	weigh
khsgall	install
sdhskgkfd	sensitive
sjggdsgklh	suggestion
fddkld	recipe
fdaslhagld	reasonable
lfdlafagklh	preparation
sllddh	wooden
dldjdhgafh	elementary
dlhddfg	concert
aggfdsskfd	aggressive
falsd	false
khgdhgklh	intention
dhahhdl	channel
dsgfdjd	extreme
gjgd	tube
dfaskhg	drawing
lflgdkh	protein
ajkg	quit
agsdhdd	absence
lagkh	latin
falkdlh	rapidly
dkfdfskgh	diversity
hlhdsg	honest
laldsgkhkah	palestinian
ladd	pace
djlllhjdhg	employment
sldakdf	speaker
kjlfdssklh	impression
dssah	essay
fdsllhddhg	respondent
gkahg	giant
dakd	cake
hksglfkah	historian
hdglgkagd	negotiate
fdsglfd	restore
sjgsgahgkal	substantial
lll	pop
slddkalksg	specialist
lfkgkh	origin
allflfal	approval
ajkdglh	quietly
adfksd	advise
dlhfdhgklhal	conventional
ddlgh	depth
sdalgh	wealth
dksagklkgh	disability
shdll	shell
dfkgkdkad	criticize
dffddgkfdlh	effectively
gklllgkdal	biological
lhklh	onion
ddljgh	deputy
assjfd	assure
jad	mad
dfkgdfka	criteria
ddaldf	dealer
fka	via
jgklkgh	utility
lfddksdlh	precisely
afksd	arise
afjdd	armed
hdfdfghdldss	nevertheless
hkghsah	highway
dlkhkdal	clinical
fljgkhd	routine
sagd	wage
hlfjallh	normally
lhfasd	phrase
khgfddkdhg	ingredient
sgakd	stake
jjslkj	muslim
fkgdf	fiber
adgkfksg	activist
kslajkd	islamic
shal	snap
gdfflfksj	terrorism
fdfjgdd	refugee
khdlfllfagd	incorporate
hkl	hip
jlgkjagd	ultimate
sskgdh	switch
dlfllfagklh	corporation
faljagld	valuable
assjjlgklh	assumption
gaffkdf	barrier
jkhlf	minor
lflfksklh	provision
kklldf	killer
asskgh	assign
gahg	gang
ddfdlllkhg	developing
dlasskd	classic
dhdjkdal	chemical
lagdl	label
gddh	teen
khdds	index
fadagklh	vacation
adfldagd	advocate
dsgfalfdkhafh	extraordinary
hdafdh	heaven
fljgh	rough
lfdghahg	pregnant
dksgahg	distant
dfaja	drama
sagdllkgd	satellite
ldfslhallh	personally
dlldk	clock
dhldllagd	chocolate
kgalkah	italian
dahadkah	canadian
ddklkhg	ceiling
ssddl	sweep
adfdfgkskhg	advertising
jhkfdfsal	universal
slkh	spin
gjgglh	button
fahk	rank
dafkhdss	darkness
dllghkhg	clothing
sjldf	super
hkdld	yield
fdhdd	fence
llfgfakg	portrait
sjffkfal	survival
fljghlh	roughly
lassjkg	lawsuit
gdsgkjlhh	testimony
gjhdh	bunch
gjfddh	burden
fdadg	react
dhajgdf	chamber
fjfhkgjfd	furniture
dllldfagklh	cooperation
sgfkhg	string
ddfdjlhh	ceremony
dljjjhkdagd	communicate
lflfkld	profile
jddhahksj	mechanism
dksagfdd	disagree
ldhalgh	penalty
kd	ie
fdslfg	resort
ddsgfjdgklh	destruction
jhlkkdlh	unlikely
gkssjd	tissue
dlhsgkgjgklhal	constitutional
lahg	pant
sgfahgdf	stranger
khfddgklh	infection
dagkhdg	cabinet
gflkdh	broken
allld	apple
dlddgfkd	electric
lfldddd	proceed
lkgdfafh	literary
fkfjs	virus
sgjlkd	stupid
dksljgd	dispute
flfgjhd	fortune
sgfagdgkd	strategic
assksgahg	assistant
lfdfdljd	overcome
fdjafkagld	remarkable
lddjlh	occupy
sgagksgkds	statistics
shlllkhg	shopping
dljskh	cousin
dhdljhgdf	encounter
khkgkallh	initially
glkhd	blind
llfg	port
dlddgfkdkgh	electricity
gdhdgkd	genetic
adfksdf	adviser
sllkdsjah	spokesman
laggdf	latter
khddhgkfd	incentive
gfahslagd	translate
addjfagd	accurate
shdfdas	whereas
gdfflf	terror
dslahsklh	expansion
dlkgd	elite
llhjlkd	olympic
dkfg	dirt
ldd	odd
gjlldg	bullet
gkghg	tight
dhafg	chart
sllaf	solar
sajafd	square
dlhddhgfagklh	concentration
dljllkdagdd	complicated
gdhglh	gently
dhajlklh	champion
sddhafkl	scenario
gdldsdlld	telescope
fdflddgklh	reflection
fdflljgklh	revolution
sgfkl	strip
khgdflfdg	interpret
ffkdhdlh	friendly
gljfhajdhg	tournament
fkdgklh	fiction
ddgddg	detect
gfdjdhdljs	tremendous
lkfdgkjd	lifetime
fddljjdhdagklh	recommendation
sdhaglf	senator
hjhgkhg	hunting
salad	salad
gjafahgdd	guarantee
khhlddhg	innocent
gljhdafh	boundary
lajsd	pause
fdjlgd	remote
sagksfadgklh	satisfaction
jljfhal	journal
gdhdh	bench
llfdf	lover
fas	raw
asafdhdss	awareness
sjflfkskhg	surprising
skghdfas	withdraw
dddk	deck
skjklaflh	similarly
hdslh	newly
llld	pole
gdsgkfh	testify
jldd	mode
dkallgjd	dialogue
kjllh	imply
hagjfallh	naturally
jjgjal	mutual
fljhddf	founder
adfahddd	advanced
dksjkss	dismiss
akfdfafg	aircraft
ddlkfdfh	delivery
jakhlh	mainly
ffddad	freeze
llagflfj	platform
fkhahdd	finance
skhk	sink
aggfadgkfd	attractive
dkfdfsd	diverse
fdldfahg	relevant
kddal	ideal
jlh	joy
fdgjlaflh	regularly
slfkkhg	working
dfllfd	evolve
shllgkhg	shooting
lafglh	partly
jhkhlsh	unknown
lffdhsd	offense
dljhgdf	counter
dha	dna
llgdhgkallh	potentially
ghkfgh	thirty
jjsgkfh	justify
lflgdsg	protest
dfash	crash
gdfflfksg	terrorist
khskghg	insight
llssdss	possess
lllkgkdallh	politically
dsgdhskfd	extensive
dlksldd	episode
sskj	swim
fajlg	fault
lllsd	loose
shlfglh	shortly
lfkgkhallh	originally
dlhskddfagld	considerable
lfklf	prior
khgdllddgjal	intellectual
assajlg	assault
fdlas	relax
sgakf	stair
adfdhgjfd	adventure
dsgdfhal	external
lfllf	proof
dlhfkddhg	confident
hdadajafgdfs	headquarters
sjdddh	sudden
dkfgh	dirty
fkllagklh	violation
glhgjd	tongue
lkddhsd	license
shdlgdf	shelter
fjg	rub
dlhgflfdfsh	controversy
dhgfahdd	entrance
lflldflh	properly
ddfdhskfd	defensive
gfagddh	tragedy
dhafadgdfkad	characterize
fjhdfal	funeral
lflfdssklh	profession
algdf	alter
dlhsgkgjgd	constitute
dsgaglkshjdhg	establishment
sajddad	squeeze
kjagkhagklh	imagination
jask	mask
dlhfdfg	convert
dljlfdhdhskfd	comprehensive
lfljkhdhg	prominent
lfdsdhgagklh	presentation
fdgafdldss	regardless
llad	load
sgagld	stable
khgfldjdgklh	introduction
lfdgdhd	pretend
dlddflh	elderly
fdlfdsdhgagklh	representation
dddf	deer
sllkg	split
lafghdfshkl	partnership
lllljgklh	pollution
djkssklh	emission
sgdadh	steady
fkgal	vital
dafhkhgs	earnings
lfdh	oven
dksgkhdgklh	distinction
sdgjdhg	segment
hlshdfd	nowhere
lldg	poet
jdfd	mere
dsdkgkhg	exciting
fafkagklh	variation
dljflfg	comfort
fadkdal	radical
adalg	adapt
kfksh	irish
hlhdh	honey
dlffdsllhddhg	correspondent
lald	pale
jjskdkah	musician
skghkfkdahdd	significance
fdssdl	vessel
sglfagd	storage
fldd	flee
jj-hjj	mm-hmm
ldaghdf	leather
dksgfkgjgd	distribute
dflljgklh	evolution
kll	ill
gfkgd	tribe
shdlf	shelf
gfahdfaghdf	grandfather
lash	lawn
gjhdf	buyer
dkhkhg	dining
sksdlj	wisdom
dljhdkl	council
fjlhdfagld	vulnerable
khsgahdd	instance
gaflkd	garlic
dalagklkgh	capability
lldgfh	poetry
ddldgfkgh	celebrity
gfadjallh	gradually
sgagklkgh	stability
fahgash	fantasy
sdafdd	scared
lllg	plot
ffajdslfk	framework
ddldhdkhg	depending
lhglkhg	ongoing
lshdhlllgh	psychology
dljhsdllf	counselor
dhalgdf	chapter
dkflfdd	divorce
lsd	owe
aghldgkd	athletic
slkghg	slight
jagh	math
shadd	shade
gakl	tail
sjsgakh	sustain
jljhg	mount
lglkgagklh	obligation
ahgld	angle
lalj	palm
dkffdf	differ
djsglj	custom
ddlhljksg	economist
fkfgddh	fifteen
ddldgfagklh	celebration
dffkdkdhg	efficient
dljllskgklh	composition
sagksfh	satisfy
gfkdflh	briefly
dafglh	carbon
dllsdf	closer
dlhsjjd	consume
sdhdjd	scheme
dfadk	crack
ffdajdhdh	frequency
glgaddl	tobacco
sjffkflf	survivor
gdskdds	besides
lshdhlllgksg	psychologist
sdalghh	wealthy
galash	galaxy
gkfdh	given
skk	ski
lkjkgagklh	limitation
alllkhgjdhg	appointment
lfdfdfdhdd	preference
jdgdf	meter
dslllsklh	explosion
ljglkdlh	publicly
khdfddkgld	incredible
fkghgdf	fighter
adjkssklh	admission
ddjdagd	educate
lakhfjl	painful
ffkdhdshkl	friendship
akdd	aide
khfahg	infant
daldjlagd	calculate
fkd	rid
llfdh	porch
gdhddhdh	tendency
jhkflfj	uniform
flfjagklh	formation
sdhllafshkl	scholarship
fdsdffagklh	reservation
dffkdkdhdh	efficiency
ajalkfh	qualify
jall	mall
ddfkfd	derive
sdahdal	scandal
ld	pc
hdllfjl	helpful
kjlfdss	impress
hddl	heel
fdsdjgld	resemble
lfkfadh	privacy
fagfkd	fabric
lflllfgklh	proportion
gjkddlkhd	guideline
fkfld	rifle
jakhgdhahdd	maintenance
dlhfkdgklh	conviction
lfgahkd	organic
gdhg	tent
dsajkhagklh	examination
ljglkshdf	publisher
sgfdhgghdh	strengthen
lflllsdd	proposed
jhgh	myth
sllhksgkdagdd	sophisticated
dls	cow
dgd	etc
sgahdkhg	standing
aslddl	asleep
gdhhks	tennis
hdffd	nerve
gaffdl	barrel
gljgkhg	bombing
jdjgdfshkl	membership
fagkl	ratio
jdhj	menu
dlhgflfdfskal	controversial
ddsldfagd	desperate
lkfdsghld	lifestyle
hjjlf	humor
lljd	loud
gllfd	glove
sjffkdkdhg	sufficient
haffagkfd	narrative
lhlglgfalhdf	photographer
hdlkdllgdf	helicopter
jlddsg	modest
lflfkddf	provider
ddlah	delay
agfkdjlgjfal	agricultural
dsllldd	explode
sgflkd	stroke
sdlld	scope
ljhkshjdhg	punishment
hahdfjl	handful
gadlh	badly
hlfkalh	horizon
djfkljs	curious
dlshglsh	downtown
gkflffkdhd	girlfriend
lfljlg	prompt
dhlldsgdfll	cholesterol
agslfg	absorb
adjjsgjdhg	adjustment
gaslahdf	taxpayer
dagdf	eager
lfkhdklal	principal
ddgakldd	detailed
jlgkfagklh	motivation
asskghjdhg	assignment
fdsgfkdgklh	restriction
laglfaglfh	laboratory
slfkshll	workshop
dkffdfdhglh	differently
ajgl	auto
fljahgkd	romantic
dlgglh	cotton
jlglf	motor
sjd	sue
flaflf	flavor
lfdflllk	overlook
fllag	float
jhddfgl	undergo
sdajdhdd	sequence
ddjlhsgfagklh	demonstration
jdg	jet
lfahgd	orange
dlhsjjlgklh	consumption
assdfg	assert
gladd	blade
gdjllfafh	temporary
jddkdagklh	medication
dagkh	cabin
gkgd	bite
ddkgklh	edition
falldh	valley
hljfs	yours
lkgdh	pitch
gfkllkahg	brilliant
fdfsjs	versus
jahjfadgjfkhg	manufacturing
agslljgd	absolute
dhdf	chef
dksdfkjkhagklh	discrimination
lffdhskfd	offensive
gllj	boom
fdgksgdf	register
alllkhg	appoint
hdfkgagd	heritage
dljkhahg	dominant
sjdddssfjllh	successfully
shkg	shit
ldjlh	lemon
hjhgfh	hungry
sahddf	wander
sjgjkg	submit
ddlhljkds	economics
hakdd	naked
ahgkdklagd	anticipate
ldgadh	legacy
dsgdhsklh	extension
shfjg	shrug
gaggdfh	battery
affkfal	arrival
ldgkgkjagd	legitimate
lfkdhgagklh	orientation
khflagklh	inflation
flajd	flame
dljsgdf	cluster
ddldhddhg	dependent
shlsdf	shower
khsgkgjgklhal	institutional
ddlkdg	depict
lldfagkhg	operating
fldsh	flesh
gafagd	garage
lldfaglf	operator
khsgfjdglf	instructor
dlllalsd	collapse
glffls	borrow
fjfghdfjlfd	furthermore
dljddh	comedy
jlfggagd	mortgage
sahdgklh	sanction
dkfklkah	civilian
gsdlfd	twelve
sddklh	weekly
hagkgag	habitat
gfjsh	brush
dlhsdkljshdss	consciousness
ddflgd	devote
jdasjfdjdhg	measurement
lflfkhdd	province
sdkad	seize
dghkds	ethics
hljkhagklh	nomination
ldfjkssklh	permission
sksd	wise
adgfdss	actress
sjjjkg	summit
adkd	acid
ldds	odds
gkfgdd	gifted
ffjsgfagklh	frustration
jddkjj	medium
lhhskdallh	physically
dksgkhgjksh	distinguish
fdldagddlh	repeatedly
ljhg	lung
fjhhkhg	running
dksgkhdg	distinct
afgksgkd	artistic
dksdljfsd	discourse
gaskdg	basket
ah	ah
fkghgkhg	fighting
kjlfdsskfd	impressive
dljldgkglf	competitor
jglh	ugly
slffkdd	worried
llfgfah	portray
llsddf	powder
ghlsg	ghost
ldfsjadd	persuade
jlddfagd	moderate
sjgsdajdhg	subsequent
dlhgkhjdd	continued
dllkkd	cookie
daffkdf	carrier
dllkkhg	cooking
ffdajdhg	frequent
asfjl	awful
adjkfd	admire
jkfadld	miracle
dsdddd	exceed
fhhghj	rhythm
skddslfdad	widespread
kkllkhg	killing
llfdlh	lovely
dhafkgh	charity
sdfklg	script
gadgkd	tactic
kddhgkfkdagklh	identification
gfahsflfjagklh	transformation
dfdfhdah	everyday
hdadlkhd	headline
fdhgjfd	venture
khfasklh	invasion
hlhdghdldss	nonetheless
addajagd	adequate
lkahl	piano
gflddfh	grocery
khgdhskgh	intensity
dshkgkg	exhibit
glahkdg	blanket
jafgkh	margin
ajafgdfgadk	quarterback
jljsd	mouse
dlhdfdgd	concrete
lfdsdfklgklh	prescription
affkdah-ajdfkdah	african-american
dhasd	chase
fddfjkg	recruit
lagdh	patch
dlhsdhsjs	consensus
hlfflf	horror
fddlfdkhg	recording
dhahgkhg	changing
lakhgdf	painter
dlllhkal	colonial
gaad	gaze
dljfagd	courage
lfdghahdh	pregnancy
ssdaf	swear
ddfdag	defeat
fdkhflfdd	reinforce
dlhfjsklh	confusion
lddjlagklh	occupation
ddaf	dear
dlal	coal
sadfdd	sacred
flfjjla	formula
dlghkgkfd	cognitive
dlllddgkfd	collective
dsadg	exact
jhdld	uncle
dalgakh	captain
aggfkgjgd	attribute
hljdldss	homeless
galldfh	gallery
sldddf	soccer
ddfdhdahg	defendant
gjhhdl	tunnel
fkghdss	fitness
lal	lap
dlhgakhdf	container
fkfgjd	virtue
agflad	abroad
afdhkgddg	architect
dfajagkdallh	dramatically
jakdjl	makeup
khajkfh	inquiry
flsd	rose
sjflfkskhglh	surprisingly
hkghlkghg	highlight
dddfdasd	decrease
khdkdagklh	indication
ahhkfdfsafh	anniversary
dljdh	couch
allkahdd	alliance
hhllghdsks	hypothesis
glhffkdhd	boyfriend
dljllsd	compose
jdss	mess
ldgdhd	legend
fdgjlagd	regulate
adlldsddhg	adolescent
shkhd	shine
hlfj	norm
jlsdg	upset
fdjafk	remark
fdskgh	resign
fdsafd	reward
gdhgld	gentle
fdlagdd	related
lfgah	organ
lkghglh	lightly
dlhddfhkhg	concerning
khfdhg	invent
lajghgdf	laughter
hlfghsdsg	northwest
dljhsdlkhg	counseling
fdddkfdf	receiver
fkgjal	ritual
khsddg	insect
khgdffjlg	interrupt
saljlh	salmon
gfadkhg	trading
jagkd	magic
sjldfklf	superior
dljgag	combat
sgdj	stem
sjfgdlh	surgeon
adddlgagld	acceptable
lhhskds	physics
fald	rape
dljhsdl	counsel
jdahs	jeans
hjhg	hunt
dlhgkhjljs	continuous
ddhl	echo
lkll	pill
dsdkgdd	excited
sdjllgjfd	sculpture
dljlljhd	compound
khgdgfagd	integrate
flljf	flour
gkggdf	bitter
gafd	bare
sllld	slope
fdhg	rent
lfdskddhdh	presidency
sdffkhg	serving
sjggld	subtle
gfdaglh	greatly
gkshll	bishop
dfkhkkhg	drinking
adddlgahdd	acceptance
ljjl	pump
dahdh	candy
dfkl	evil
lldasdd	pleased
jddal	medal
sllhslf	sponsor
dghkdal	ethical
sddlhdafh	secondary
slaj	slam
dsllfg	export
dsldfkjdhgal	experimental
jdlg	melt
jkdhkghg	midnight
djffd	curve
khgdgfkgh	integrity
dhgkgld	entitle
dfkddhg	evident
llgkd	logic
dssdhdd	essence
dsdljdd	exclude
hafsh	harsh
dllsdg	closet
sjgjfgah	suburban
gfddg	greet
khgdfklf	interior
dlffkdlf	corridor
fdgakl	retail
lkgdhdf	pitcher
jafdh	march
dsdjsd	excuse
sdakhdss	weakness
dlasskdal	classical
dsgkjagdd	estimated
g-shkfg	t-shirt
jhdjlllhjdhg	unemployment
dkfklkaagklh	civilization
fdfdfsd	reverse
jksskhg	missing
dlffdlagklh	correlation
hjjahkgh	humanity
flash	flash
ddfdllldf	developer
fdlkagld	reliable
dsdkgdjdhg	excitement
kslaj	islam
fljah	roman
afdhkgddgjfd	architecture
lddasklhal	occasional
adjkhksgfagkfd	administrative
dlgls	elbow
ddadlh	deadly
hkslahkd	hispanic
alldgagklh	allegation
dlhfjsd	confuse
akfllahd	airplane
jlhghlh	monthly
djdk	duck
klfdah	korean
lldad	plead
khkgkagd	initiate
lddgjfd	lecture
sksgh	sixth
jakhsgfdaj	mainstream
sjgjfg	suburb
sahdskdh	sandwich
gfjhk	trunk
fjjlf	rumor
kjlldjdhgagklh	implementation
ssallls	swallow
jlgkfagd	motivate
fdhddf	render
llhggkjd	longtime
gfal	trap
fdsgfkdg	restrict
dllgh	cloth
sddjkhglh	seemingly
ldgkslagkfd	legislative
dffddgkfdhdss	effectiveness
dhflfdd	enforce
ldhs	lens
khslddglf	inspector
ldhd	lend
llakh	plain
dljlahklh	companion
dlhgdhd	contend
hakl	nail
affah	array
sgfkdg	strict
assdjgld	assemble
ffahklh	frankly
hah	hay
hallsah	hallway
khdfkgagld	inevitable
sljghsdsg	southwest
jlhsgdf	monster
jhdslddgdd	unexpected
lgsgadld	obstacle
fadklkgagd	facilitate
fkl	rip
hdfg	herb
lfdfshdljkhg	overwhelming
khgdgfagklh	integration
dfhsgal	crystal
fdddssklh	recession
sfkggdh	written
jlgkfd	motive
fllld	flood
ldh	pen
lshdfshkl	ownership
hkghgjafd	nightmare
khslddgklh	inspection
sjldffkslf	supervisor
dlhsjlg	consult
afdha	arena
dkaghlsks	diagnosis
llssdssklh	possession
flfgkfd	forgive
dlhsksgdhglh	consistently
gasdjdhg	basement
dfkfg	drift
dfakh	drain
lflsddjgklh	prosecution
jaskjjj	maximum
ahhljhddjdhg	announcement
saffklf	warrior
lfddkdgklh	prediction
gadgdfka	bacteria
ajdsgklhhakfd	questionnaire
jjd	mud
khffasgfjdgjfd	infrastructure
hjffh	hurry
lfkfkldgd	privilege
gdjlld	temple
ljgdllf	outdoor
sjdk	suck
ahd/lf	and/or
gfladdasg	broadcast
fd	re
ldal	leap
fahdlj	random
sfksg	wrist
djfgakh	curtain
llhd	pond
dljakh	domain
gjklg	guilt
daggld	cattle
salkkhg	walking
llahlff	playoff
jkhkjjj	minimum
fksdal	fiscal
skkfg	skirt
djjl	dump
hdhdd	hence
dagagasd	database
jhdljflfgagld	uncomfortable
dsddjgd	execute
lkjg	limb
kddlllgh	ideology
gjhd	tune
dlhgkhjkhg	continuing
hafj	harm
faklflad	railroad
dhdjfd	endure
fadkagklh	radiation
hlfh	horn
dhflhkd	chronic
ldaddfjl	peaceful
khhlfagklh	innovation
sgfakh	strain
gjkgaf	guitar
fdlladdjdhg	replacement
gdhafd	behave
adjkhksgdf	administer
skjjlgahdljslh	simultaneously
ajdhdjdhg	amendment
lad	pad
gfahsjkssklh	transmission
asakg	await
fdgkfdd	retired
gfkggdf	trigger
slkll	spill
gfagdfjl	grateful
fkfgjal	virtual
dlllhh	colony
adllgklh	adoption
khdkgdhljs	indigenous
dllsdd	closed
dlhfkdg	convict
glsdl	towel
jldkfh	modify
lafgkdld	particle
lfkad	prize
lahdkhg	landing
gllsg	boost
alafj	alarm
fdsgkfal	festival
sdkfd	weird
jhddfjkhd	undermine
ffdshjah	freshman
ssdag	sweat
ljgdf	outer
dfjhk	drunk
sdlafagklh	separation
gfadkgklhallh	traditionally
glfdfh	govern
sljghdasg	southeast
khgdllkgdhg	intelligent
shdfdfdf	wherever
galllg	ballot
fhdglfkd	rhetoric
dlhfkhddd	convinced
dfkfkhg	driving
fkgajkh	vitamin
dhghjskasj	enthusiasm
addljjldagd	accommodate
lfaksd	praise
khjjfd	injure
sklddfhdss	wilderness
dhdldss	endless
jahdagd	mandate
fdslddgkfdlh	respectively
jhddfgakhgh	uncertainty
dhals	chaos
jddhahkdal	mechanical
dahfas	canvas
llggh	lobby
lflfljhd	profound
flfjag	format
gfakg	trait
djffdhdh	currency
gjfkdh	turkey
fdsdffd	reserve
asgflhljdf	astronomer
dlffjlgklh	corruption
dlhgfadglf	contractor
allllgkad	apologize
dldgfkhd	doctrine
gdhjkhd	genuine
ghjjg	thumb
jhkgh	unity
dljlfljksd	compromise
hlffkgld	horrible
gdhafklfal	behavioral
dsdljskfd	exclusive
sdaggdf	scatter
dljjlhlh	commonly
dlhfdh	convey
gsksg	twist
dljlldskgh	complexity
flfk	fork
dksk	disk
fdlkdfd	relieve
sjslkdklh	suspicion
hdalgh-dafd	health-care
fdskddhdd	residence
shajd	shame
jdahkhgfjl	meaningful
skddsalk	sidewalk
llhjlkds	olympics
gddhhlllgkdal	technological
skghagjfd	signature
lldasahg	pleasant
sls	wow
sjsldhd	suspend
fdgdl	rebel
ffladh	frozen
slljsd	spouse
fljkd	fluid
ldhsklh	pension
fdsjjd	resume
ghdlfdgkdal	theoretical
sldkjj	sodium
lfljlgklh	promotion
ddlkdagd	delicate
flfdhdad	forehead
fdgjkld	rebuild
gljhdd	bounce
dlddgfkdal	electrical
hllk	hook
ddgddgkfd	detective
gfafdldf	traveler
dlkdk	click
dljldhsagklh	compensation
dskg	exit
aggfadgklh	attraction
dddkdagd	dedicate
alglgdghdf	altogether
lkdkjl	pickup
daffd	carve
hdddld	needle
gdllh	belly
llfgfllkl	portfolio
shjggld	shuttle
khfkskgld	invisible
gkjkhg	timing
dhgagdjdhg	engagement
ahkld	ankle
gfahsadgklh	transaction
fdsdjd	rescue
dljhgdflafg	counterpart
hksglfkdallh	historically
fkfjlh	firmly
jkld	mild
fkddf	rider
ajkd	amid
kddhgkdal	identical
lfddksd	precise
ahskljs	anxious
sgfjdgjfal	structural
fdskddhgkal	residential
dkaghlsd	diagnose
dafglhhdfagd	carbohydrate
lkgdfgh	liberty
llsgdf	poster
ghdlllgh	theology
hlhlflfkg	nonprofit
dfasl	crawl
lshgdh	oxygen
hahdsljd	handsome
sjj	sum
lflfkddd	provided
gjskhdssjah	businessman
lfljkskhg	promising
dlhsdkljs	conscious
ddgdfjkhagklh	determination
dlhlf	donor
hdfs	hers
lasglf	pastor
jaaa	jazz
lldfa	opera
adajkskgklh	acquisition
skldlkfd	wildlife
ljhksh	punish
dajkgh	equity
dllfsah	doorway
ddlafgjfd	departure
dldfaglf	elevator
gddhagd	teenage
gjkdahdd	guidance
hallkhdss	happiness
sgagjd	statue
ljfsjkg	pursuit
fdlakf	repair
ddddhg	decent
ghj	gym
lfal	oral
dldfk	clerk
dhfdllld	envelope
fdllfgkhg	reporting
ddsgkhagklh	destination
fksg	fist
dhdlfsd	endorse
dslllfagklh	exploration
gdhdfljs	generous
ghdfdgh	thereby
khdkdaglf	indicator
sjhlkghg	sunlight
fdddgadk	feedback
slddgfjj	spectrum
ljflld	purple
lasdf	laser
fdljdgahg	reluctant
sgafgkhg	starting
dsldfgksd	expertise
lfadgkdallh	practically
dagkhg	eating
hkhg	hint
shafllh	sharply
lafadd	parade
fdalj	realm
dahddl	cancel
gldhd	blend
ghdfalksg	therapist
lddl	peel
lkaaa	pizza
fddklkdhg	recipient
hdskgagd	hesitate
flkl	flip
addljhgkhg	accounting
gkas	bias
hjh	huh
jdgalhlf	metaphor
dahdld	candle
jjdkdkal	judicial
dhgkgh	entity
sjffdfkhg	suffering
fjll-gkjd	full-time
lajl	lamp
gafgagd	garbage
sdffahg	servant
fdgjlaglfh	regulatory
dkllljagkd	diplomatic
dldgahg	elegant
fdddlgklh	reception
fahksh	vanish
ajgljagkdallh	automatically
dhkh	chin
hdddsskgh	necessity
dlhfdss	confess
fadksj	racism
sgafgdf	starter
gahkkhg	banking
dasjal	casual
gfafkgh	gravity
dhflll	enroll
dkjkhksh	diminish
lfdfdhgklh	prevention
jkhkjkad	minimize
dhll	chop
ldfflfjdf	performer
khgdhg	intent
ksllagd	isolate
khfdhglfh	inventory
lfldjdgkfd	productive
assdjglh	assembly
dkfkd	civic
sklk	silk
jaghkgjdd	magnitude
hlsgagd	hostage
dlllddglf	collector
llljlafkgh	popularity
alkdh	alien
dhhajkd	dynamic
sdafh	scary
dajagklh	equation
ahgdl	angel
lffdfkhg	offering
lhlglgfalhh	photography
glkldg	toilet
dksalllkhgdd	disappointed
lfddkljs	precious
lflhkgkg	prohibit
fdalksgkd	realistic
hkdddh	hidden
gaghdfkhg	gathering
ljgsgahdkhg	outstanding
sgjjgld	stumble
llhdlh	lonely
ajgljlgkld	automobile
afgkfkdkal	artificial
agsgfadg	abstract
ddsddhd	descend
skllh	silly
gkdd	tide
shafdd	shared
hlldfjllh	hopefully
fdadklh	readily
dllldfagd	cooperate
fdflljgklhafh	revolutionary
fljahdd	romance
hafdsafd	hardware
lkllls	pillow
kkg	kit
dlhgkhdhg	continent
sdal	seal
dkfdjkg	circuit
fjlkhg	ruling
shlfgagd	shortage
ahhjallh	annually
lagdlh	lately
sdah	scan
ddadlkhd	deadline
lflddsskhg	processing
fahdh	ranch
dlasgal	coastal
jhddfgakd	undertake
slfglh	softly
gjfhkhg	burning
fdfgal	verbal
gfkgal	tribal
fkdkdjlljs	ridiculous
ajgljagkd	automatic
dkajlhd	diamond
dfddkgklkgh	credibility
kjllfg	import
sdsjallh	sexually
dkfkhd	divine
sdhgkjdhg	sentiment
dafg	cart
lfdfsdd	oversee
l'dlldk	o'clock
dlddf	elder
lfl	pro
khslkfagklh	inspiration
djgdh	dutch
ajahgkgh	quantity
gfakldf	trailer
jagd	mate
gfddk	greek
gdhkjs	genius
jlhjjdhg	monument
ajdsg	quest
sadfkfkdd	sacrifice
khfkgagklh	invitation
addjfadh	accuracy
jjflf	juror
lffkdkallh	officially
gflkdf	broker
gfdasjfd	treasure
llhalgh	loyalty
galdhgdd	talented
gasllkhd	gasoline
sgkff	stiff
ljgljg	output
hljkhdd	nominee
dsgdhddd	extended
dkagdgds	diabetes
glskd	toxic
alldgdd	alleged
jas	jaw
jhsgdfkljs	mysterious
fldkdg	rocket
dlhagd	donate
khjagd	inmate
gadkld	tackle
dhhajkds	dynamics
ljfs	ours
dkghkgh	dignity
dafldg	carpet
lafdhgal	parental
gjggld	bubble
gjddh	buddy
gafh	barn
sslfd	sword
sdfdhgh	seventh
gllfh	glory
gkghglh	tightly
lflgddgkfd	protective
dfjj	drum
fakhg	faint
ajddh	queen
dkldjja	dilemma
khljg	input
slddkalkad	specialize
hlfghdasg	northeast
shallls	shallow
lkagklkgh	liability
sakl	sail
jdfdhahg	merchant
sgadkjj	stadium
kjlflfdd	improved
gllldh	bloody
assldkagdd	associated
skghdfasal	withdrawal
fdffkgdfaglf	refrigerator
ghlfljghlh	thoroughly
ahddsglf	ancestor
dlhddjh	condemn
sgdaj	steam
adddhg	accent
llgkjksgkd	optimistic
jhkgd	unite
dajkl	equip
shfkjl	shrimp
hljdlahd	homeland
fadk	rack
dlsgjjd	costume
sllf	wolf
dljfgfllj	courtroom
sgagjgd	statute
dafgllh	cartoon
lfldjdgkfkgh	productivity
gfkh	grin
shjgllkd	symbolic
gldss	bless
ajhg	aunt
agfkdjlgjfd	agriculture
hlsgkld	hostile
dlhddkfd	conceive
dljgkhdd	combined
khsgahglh	instantly
gahkfjlgdh	bankruptcy
faddkhd	vaccine
glhjs	bonus
dlllaglfagklh	collaboration
jksdd	mixed
llllsdd	opposed
lfgkg	orbit
gfasl	grasp
lagkdhdd	patience
slkgd	spite
gfllkdal	tropical
flgkhg	voting
lagfll	patrol
skllkhghdss	willingness
fdfdlagklh	revelation
dalj	calm
jdsdlfh	jewelry
djgah	cuban
hajl	haul
dlhdddd	concede
saglh	wagon
afgdfsafd	afterward
slddgadjlaf	spectacular
fjkh	ruin
shddf	sheer
kjjjhd	immune
fdlkagklkgh	reliability
ass	ass
allhgskdd	alongside
dslgkd	exotic
fasdkhagkhg	fascinating
dlkl	clip
ghkgh	thigh
gjll	bull
dfasdf	drawer
dksdljfagd	discourage
dllfdkhaglf	coordinator
kddlllgkdal	ideological
fjhhdf	runner
sddjlaf	secular
khgkjagd	intimate
djlkfd	empire
dsaj	exam
dldjjdhgafh	documentary
hdjgfal	neutral
gklllgh	biology
fldskgld	flexible
lflgfdsskfd	progressive
dlhslkfadh	conspiracy
dasjalgh	casualty
fdljglkd	republic
dsddjgklh	execution
gdffkfkd	terrific
fjhdgklhal	functional
khsgkhdg	instinct
gdajjagd	teammate
aljjkhjj	aluminum
shldfdf	whoever
jkhksgfh	ministry
fdfdkdg	verdict
khsgfjdg	instruct
skjll	skull
sdlf-dsgddj	self-esteem
dllldfagkfd	cooperative
jahkljlagd	manipulate
lfadgkgklhdf	practitioner
ddkg	edit
ljaald	puzzle
jjshfllj	mushroom
sjgskdh	subsidy
glkl	boil
gfagkd	tragic
jaghdjagkds	mathematics
jddhahkd	mechanic
jaf	jar
dafghajakd	earthquake
llfk	pork
dfdagkfkgh	creativity
safdlh	safely
jhddflhkhg	underlying
ddssdfg	dessert
shjlaghh	sympathy
fkshdfjah	fisherman
khdfddkglh	incredibly
ksllagklh	isolation
sldk	sock
dldfdh	eleven
sdsh	sexy
dhgfdlfdhdjf	entrepreneur
shhdfljd	syndrome
gjfdaj	bureau
slfklladd	workplace
ajgkgklh	ambition
gljdhdlsh	touchdown
jgklkad	utilize
gfddad	breeze
dlsglh	costly
ajgkgkljs	ambitious
dhfksgkahkgh	christianity
lfdsjjaglh	presumably
khfljdhgkal	influential
gfahslagklh	translation
jhddfgakh	uncertain
dkssllfd	dissolve
sgagksgkdal	statistical
jdgfllllkgah	metropolitan
flllkhg	rolling
adsghdgkd	aesthetic
sldll	spell
khsdfg	insert
hdljdg	helmet
saksg	waist
dslddgdd	expected
lklh	lion
addljllkshjdhg	accomplishment
flhal	royal
lahkd	panic
dfjsh	crush
adgkfdlh	actively
dlkff	cliff
jkhkjal	minimal
flfgjhagdlh	fortunately
dldakhd	cocaine
klljsklh	illusion
ahlhhjljs	anonymous
glldfagd	tolerate
allfddkagklh	appreciation
dljjkssklhdf	commissioner
fldskgklkgh	flexibility
khsgfjdgklhal	instructional
sdfajgld	scramble
daskhl	casino
gjjlf	tumor
dddlfagd	decorate
ljlsd	pulse
dajkfaldhg	equivalent
fksdd	fixed
dsldfkdhddd	experienced
dlhagklh	donation
dkafh	diary
skglkhg	sibling
kflhh	irony
slllh	spoon
jkdsg	midst
alldh	alley
khgdfadg	interact
djgd	cute
fkfal	rival
shlfg-gdfj	short-term
lkh	pin
hldkdh	hockey
lasskhg	passing
ldfsksg	persist
sjlllkdf	supplier
khlsh	known
jljdhgjj	momentum
ljfsd	purse
shdd	shed
lkajkd	liquid
kdlh	icon
dldlhahg	elephant
dlhsdajdhglh	consequently
ldgkslagjfd	legislature
ffahdhksd	franchise
dlffddglh	correctly
jdhgallh	mentally
flsgdf	foster
gkdhdld	bicycle
dhdljfagkhg	encouraging
dhdag	cheat
hdal	heal
fklgdf	filter
faggkg	rabbit
dlkh	coin
dslllkg	exploit
adddsskgld	accessible
lfgahksj	organism
sdhsagklh	sensation
lafgkallh	partially
jlsgakfs	upstairs
dfkdd	dried
dlhsdffagklh	conservation
gadkhafd	backyard
dhafgdf	charter
dlhsdhg	consent
dljlfksd	comprise
fdjkhddf	reminder
alkkd	alike
lladdjdhg	placement
dljgh	dough
gfahddhkld	grandchild
daj	dam
fdllfgddlh	reportedly
sdll-khlsh	well-known
sjffljhdkhg	surrounding
ddlllgkdal	ecological
ljgfkg	outfit
jhlfdddddhgdd	unprecedented
dlljjhksg	columnist
slfkljg	workout
lfdlkjkhafh	preliminary
lagdhg	patent
gfash	trash
dksagldd	disabled
gflss	gross
dajh	damn
hlfjlhd	hormone
ldhdkl	pencil
fflhgkdf	frontier
slfah	spray
dksdllsd	disclose
djsgldh	custody
gahkdf	banker
gdasg	beast
khgdffdfd	interfere
lak	oak
dkghgh	eighth
hlgdgllk	notebook
ljglkhd	outline
aggdhdahdd	attendance
slddjlagklh	speculation
jhdlfdf	uncover
gdhalf	behalf
khhlfagkfd	innovative
shafk	shark
jkll	mill
khsgallagklh	installation
sgkjjlagd	stimulate
fdfgkdal	vertical
sskjjkhg	swimming
flddg	fleet
dagallg	catalog
ljgskddf	outsider
ddsldfagdlh	desperately
sgahdd	stance
dljldl	compel
sdhskgkfkgh	sensitivity
sljddah	someday
khsgahg	instant
ddgjg	debut
lfldlakj	proclaim
slfldskdd	worldwide
hkkd	hike
fdajkfdd	required
dlhfflhgagklh	confrontation
dlllffjl	colorful
dlhsgkgjgklh	constitution
gfakhdf	trainer
ghahksgkfkhg	thanksgiving
sddhg	scent
sgadk	stack
dhdgfls	eyebrow
sadk	sack
ddasd	cease
khhdfkg	inherit
lklhddf	pioneer
lfgahkaagklhal	organizational
gdsggllk	textbook
hasgh	nasty
shfkhk	shrink
djdfgkhg	emerging
shdag	wheat
fkdfdd	fierce
dhfksklh	envision
fagklhal	rational
kkhgdlj	kingdom
aksld	aisle
sdakdh	weaken
lflgldll	protocol
dsdljskfdlh	exclusively
fldal	vocal
jafkdglladd	marketplace
lldhlh	openly
jhfakf	unfair
gdffakh	terrain
ddlllh	deploy
fkskh	risky
lasga	pasta
gdhfd	genre
dksgfadg	distract
jdfkg	merit
llahhdf	planner
ddlfdssdd	depressed
dhjhk	chunk
dllsdsg	closest
dksdljhg	discount
ladddf	ladder
jjhgld	jungle
jkgfagklh	migration
gfdaghkhg	breathing
khfadd	invade
hjffkdahd	hurricane
fdgakldf	retailer
dlasskfh	classify
dljl	coup
ajgassadlf	ambassador
ddhskgh	density
sjlllfgkfd	supportive
djfklskgh	curiosity
skkl	skip
aggfdssklh	aggression
sgkjjljs	stimulus
jljfhalksj	journalism
flglg	robot
dkl	dip
lkkdsksd	likewise
khflfjal	informal
ldfskah	persian
fdaghdf	feather
slhdfd	sphere
gkghgdh	tighten
ldfddkfdd	perceived
ljglkdkgh	publicity
jhflld	unfold
sdll-gdkhg	well-being
falkdkgh	validity
ddlshsgdj	ecosystem
sgfkdglh	strictly
lafgkal	partial
dlllaf	collar
dljllkahdd	compliance
sgfdak	streak
sjlllsddlh	supposedly
adddd	added
gjklddf	builder
glkjlsd	glimpse
lfdjksd	premise
slddkalgh	specialty
dddj	deem
afgkfadg	artifact
shdak	sneak
jlhkdh	monkey
jdhglf	mentor
gsl-ghkfds	two-thirds
lksgdhdf	listener
lkghghkhg	lightning
ldgallh	legally
slddfd	sleeve
dksalllkhgjdhg	disappointment
dksgjfg	disturb
dsddsskfd	excessive
hkgh-gddh	high-tech
ddgfks	debris
fld	rod
llgkdal	logical
ash	ash
sldkallh	socially
lafksh	parish
slafdfh	slavery
glahk	blank
dljjldkgh	commodity
djfd	cure
jkhdfal	mineral
dhkhg	dying
ddfdllljdhgal	developmental
fasgdf	faster
halfsah	halfway
dajalkgh	equality
ddjdgdfh	cemetery
hafassjdhg	harassment
ddlkgdfagdlh	deliberately
fajd	fame
fdgfdg	regret
sgfkkkhg	striking
lkkdlkhlld	likelihood
dafflg	carrot
agll	atop
fkj	rim
djgaffassdd	embarrassed
fjdkkhg	fucking
dlkhg	cling
ksllagdd	isolated
glkhk	blink
sjslkdkljs	suspicious
shddldhakf	wheelchair
sajad	squad
dlkgkgld	eligible
lflddsslf	processor
lljhgd	plunge
ddjlgfalhkd	demographic
dhkll	chill
fdfjgd	refuge
sgddf	steer
ldgkslaglf	legislator
fallh	rally
lflgfajjkhg	programming
dhddf	cheer
ljgldg	outlet
khgadg	intact
fdhdlf	vendor
ghfkfd	thrive
ldahjg	peanut
dhds	chew
dlaglfagd	elaborate
dlhddlgklh	conception
ajdgklh	auction
sgdak	steak
dljllh	comply
gfkjjlh	triumph
shafdhllddf	shareholder
dljlafagld	comparable
gfahsllfg	transport
dlhsdkdhdd	conscience
daldjlagklh	calculation
dlhskddfaglh	considerably
khgdffal	interval
sdfagdh	scratch
asakd	awake
jjfksdkdgklh	jurisdiction
khdfkgaglh	inevitably
fdjkhksg	feminist
dlhsgfakhg	constraint
djlgklhallh	emotionally
dslddkgklh	expedition
alldgddlh	allegedly
skjklafkgh	similarity
gjgg	butt
djjg	dumb
gjlk	bulk
slfkhkld	sprinkle
jlfgalkgh	mortality
lhkllsllhkdal	philosophical
dlhfdfsklh	conversion
lagflh	patron
jjhkdklal	municipal
lkfdf	liver
hafjlhh	harmony
slldlh	solely
glldfahdd	tolerance
gldsskhg	blessing
gahaha	banana
laladd	palace
flfjdflh	formerly
ldasahg	peasant
gfahdlafdhg	grandparent
lasjakdf	lawmaker
sjldfjafkdg	supermarket
dfjksd	cruise
jlgkld	mobile
daldhdaf	calendar
skdls	widow
ddllskg	deposit
gdafd	beard
gfakd	brake
sdfddhkhg	screening
kjljlsd	impulse
flfgkd	forbid
fjf	fur
gfjgal	brutal
lfddaglf	predator
llkd	poke
flljhgafh	voluntary
flfjj	forum
dahdkhg	dancing
hallklh	happily
slaf	soar
fdjlfal	removal
ajglhljh	autonomy
dhadg	enact
ghfdad	thread
lahdjafk	landmark
jhhallh	unhappy
lffdhddf	offender
dljkhg	coming
lfkfagdlh	privately
ffadgklh	fraction
dksgkhdgkfd	distinctive
gljfksj	tourism
ghfdshlld	threshold
fljgkhdlh	routinely
sjkgd	suite
fdgjlaglf	regulator
sgfas	straw
ghdlllgkdal	theological
dshajsg	exhaust
gllgd	globe
ffagkld	fragile
lgjddgklh	objection
dhdjksgfh	chemistry
lld-fashklhdd	old-fashioned
dflsddd	crowded
lfdfakl	prevail
lfdfhkghg	overnight
ddhkal	denial
fdhgal	rental
fahgasgkd	fantastic
ffagjdhg	fragment
sdfds	screw
safjgh	warmth
jhddfgfadjagd	undergraduate
hdadadhd	headache
lllkddjah	policeman
lfljddgklh	projection
sjkgagld	suitable
gfadjagklh	graduation
dfkll	drill
dfjdl	cruel
jahsklh	mansion
gfald	grape
ajghlfkad	authorize
dlggagd	cottage
dfkfdsah	driveway
dhafj	charm
sdsjalkgh	sexuality
llhal	loyal
dlah	clay
gallllh	balloon
khfdhgklh	invention
dgl	ego
hljdslfk	homework
dksd	disc
slfa	sofa
afaklagklkgh	availability
fadaf	radar
fflsh	frown
ssdagdf	sweater
fdhagklkgagklh	rehabilitation
fjggdf	rubber
fdgfdag	retreat
jllddjld	molecule
ffddlh	freely
faflfagld	favorable
sgdadklh	steadily
khgdgfagdd	integrated
ha	ha
hljhgsgdf	youngster
lfdjkjj	premium
addljhgagklkgh	accountability
lfdfshdlj	overwhelm
lhd-ghkfd	one-third
dlhgdjllagd	contemplate
jldagd	update
slafk	spark
kflhkdallh	ironically
fagkgjd	fatigue
slddjlagd	speculate
jafkdf	marker
lfdadh	preach
gjdkdg	bucket
gllhd	blond
dlhfdssklh	confession
lflflkd	provoke
jafgld	marble
sjgsgahgkallh	substantially
ddfdhddf	defender
dsllkdkg	explicit
dksgjfgkhg	disturbing
sjffdkllahdd	surveillance
jaghdgkd	magnetic
gddhhkdkah	technician
jjggdf	mutter
ddfasgagkhg	devastating
ddlafg	depart
affls	arrow
gfajja	trauma
hdkghglfkhg	neighboring
slak	soak
fkgglh	ribbon
jdahgkjd	meantime
gfahsjkg	transmit
haffdsg	harvest
dlhsddjgkfd	consecutive
dllfdkhagd	coordinate
fklg	riot
hjgfkdhg	nutrient
dkgkadhshkl	citizenship
sdfdfdlh	severely
slfdfdkghgh	sovereignty
fkdgd	ridge
lkghgkhg	lighting
slddkfh	specify
dlhgfkgjglf	contributor
ffjsgfagd	frustrate
afgkdjlagd	articulate
kjllfgahglh	importantly
gfahskg	transit
ddhsd	dense
sdjkhaf	seminar
dlddgflhkds	electronics
sjhhh	sunny
shlfgs	shorts
ssdll	swell
addjsagklh	accusation
slfgdh	soften
sgfakghgdh	straighten
gdffkglh	terribly
gfkdd	bride
gklgfalhh	biography
haaafd	hazard
dljldllkhg	compelling
sdldlj	seldom
gkld	tile
ddlhljkdallh	economically
hlhdsglh	honestly
gfljgldd	troubled
gsdhgkdgh	twentieth
galahddd	balanced
flfdkghdf	foreigner
dlhfdhkdhdd	convenience
ddlkghg	delight
gkjgdf	timber
addjfagdlh	accurately
llda	plea
gjlg	bulb
flhkhg	flying
sjsgakhagld	sustainable
ddfkl	devil
dafgl	cargo
slkhd	spine
sdlldf	seller
skklldd	skilled
jahagkhg	managing
jafkhd	marine
dldk	dock
lfgahkadd	organized
flg	fog
dkllljag	diplomat
glfkhg	boring
sljdgkjd	sometime
sjjjafh	summary
jkssklhafh	missionary
dlkddjkd	epidemic
fagal	fatal
gfkj	trim
safdhljsd	warehouse
adddldfagd	accelerate
gjggdfflh	butterfly
gflhad	bronze
dflsh	drown
khhdfdhg	inherent
hagklhskdd	nationwide
slkg	spit
khddl	kneel
fadjjj	vacuum
sdlddgdd	selected
dkdgagd	dictate
