a	a
ad	ad
adaddjkd	academic
adajkfd	acquire
adajkskgklh	acquisition
adalg	adapt
add	add
addajagd	adequate
adddd	added
adddhg	accent
adddldfagd	accelerate
adddlg	accept
adddlgagld	acceptable
adddlgahdd	acceptance
adddss	access
adddsskgld	accessible
addfdss	address
addjfadh	accuracy
addjfagd	accurate
addjfagdlh	accurately
addjsagklh	accusation
addjsd	accuse
addkddhg	accident
addkgklh	addition
addkgklhal	additional
addlfdkhg	according
addljhg	account
addljhgagklkgh	accountability
addljhgkhg	accounting
addljjldagd	accommodate
addljlahh	accompany
addljllksh	accomplish
addljllkshjdhg	accomplishment
adfahdd	advance
adfahddd	advanced
adfahgagd	advantage
adfdfgkskhg	advertising
adfdhgjfd	adventure
adfkdd	advice
adfksd	advise
adfksdf	adviser
adfldagd	advocate
adflss	across
adg	act
adgfdss	actress
adgjal	actual
adgjallh	actually
adgkfd	active
adgkfdlh	actively
adgkfkgh	activity
adgkfksg	activist
adgklh	action
adglf	actor
adhkdfd	achieve
adhkdfdjdhg	achievement
adjjsg	adjust
adjjsgjdhg	adjustment
adjkfd	admire
adjkg	admit
adjkhksgdf	administer
adjkhksgfagkfd	administrative
adjkhksgfagklh	administration
adjkhksgfaglf	administrator
adjkssklh	admission
adjlg	adult
adkd	acid
adkhlslddgd	acknowledge
adlldsddhg	adolescent
adllg	adopt
adllgklh	adoption
adsghdgkd	aesthetic
afag	arab
afaklagklkgh	availability
afaklagld	available
afda	area
afdfagd	average
afdha	arena
afdhkgddg	architect
afdhkgddgjfd	architecture
affah	array
affahgd	arrange
affahgdjdhg	arrangement
affakd	afraid
affakf	affair
affddg	affect
affdsg	arrest
affkdah	african
affkdah-ajdfkdah	african-american
affkfal	arrival
affkfd	arrive
afflfd	afford
affls	arrow
afg	art
afgdf	after
afgdfhllh	afternoon
afgdfsafd	afterward
afgjd	argue
afgjjdhg	argument
afgkdjlagd	articulate
afgkdld	article
afgkfadg	artifact
afgkfkdkal	artificial
afgksg	artist
afgksgkd	artistic
afj	arm
afjdd	armed
afjh	army
afksd	arise
afljhd	around
aflkd	avoid
ag	at
agahdlh	abandon
agakh	again
agakhsg	against
agd	age
agdhda	agenda
agdhdh	agency
agdhg	agent
agfdd	agree
agfddjdhg	agreement
agfkdjlgjfal	agricultural
agfkdjlgjfd	agriculture
agflad	abroad
aggadh	attach
aggadk	attack
aggdhd	attend
aggdhdahdd	attendance
aggdhgklh	attention
aggdjlg	attempt
aggfadg	attract
aggfadgkfd	attractive
aggfadgklh	attraction
aggfdsskfd	aggressive
aggfdssklh	aggression
aggfkgjgd	attribute
aggkgjdd	attitude
agglfhdh	attorney
aghldgd	athlete
aghldgkd	athletic
agjlslhdfd	atmosphere
agjsd	abuse
agklkgh	ability
agl	ago
agld	able
aglfd	above
aglfgklh	abortion
agljg	about
agll	atop
agsdhdd	absence
agsgfadg	abstract
agslfg	absorb
agslljgd	absolute
agslljgdlh	absolutely
ah	ah
ahalhad	analyze
ahalhsg	analyst
ahalhsks	analysis
ahd	and
ahd/lf	and/or
ahdad	ahead
ahddsglf	ancestor
ahdkdhg	ancient
ahgdf	anger
ahgdl	angel
ahgfh	angry
ahgkdklagd	anticipate
ahgld	angle
ahh	any
ahhghkhg	anything
ahhgldh	anybody
ahhjal	annual
ahhjallh	annually
ahhjlfd	anymore
ahhkfdfsafh	anniversary
ahhlhd	anyone
ahhljhdd	announce
ahhljhddjdhg	announcement
ahhsah	anyway
ahhshdfd	anywhere
ahkjal	animal
ahkld	ankle
ahlghdf	another
ahlhhjljs	anonymous
ahskdgh	anxiety
ahskljs	anxious
ahssdf	answer
aj	am
ajaakhg	amazing
ajafgdf	quarter
ajafgdfgadk	quarterback
ajahgkgh	quantity
ajalkfh	qualify
ajalkgh	quality
ajddh	queen
ajdfkdah	american
ajdgklh	auction
ajdhdjdhg	amendment
ajdkdhdd	audience
ajdsg	quest
ajdsgklh	question
ajdsgklhhakfd	questionnaire
ajgassadlf	ambassador
ajghlf	author
ajghlfkad	authorize
ajghlfkgh	authority
ajgkgklh	ambition
ajgkgkljs	ambitious
ajgl	auto
ajglhljh	autonomy
ajgljagkd	automatic
ajgljagkdallh	automatically
ajgljlgkld	automobile
ajhg	aunt
ajkd	amid
ajkdg	quiet
ajkdglh	quietly
ajkdk	quick
ajkdklh	quickly
ajkg	quit
ajkgd	quite
ajlgd	quote
ajlhg	among
ajljhg	amount
akd	aid
akdd	aide
akds	aids
akf	air
akfdfafg	aircraft
akflkhd	airline
akfllahd	airplane
akfllfg	airport
akj	aim
aksld	aisle
alafg	apart
alafgjdhg	apartment
alafj	alarm
aldlhll	alcohol
alfdadh	already
algdf	alter
algdfhagkfd	alternative
alghljgh	although
algjj	album
alglgdghdf	altogether
alhd	zone
aljjkhjj	aluminum
aljlsg	almost
alkdh	alien
alkfd	alive
alkkd	alike
all	all
allafdhg	apparent
allafdhglh	apparently
alldaf	appear
alldafahdd	appearance
alldal	appeal
alldgagklh	allegation
alldgdd	alleged
alldgddlh	allegedly
alldh	alley
allfddkagd	appreciate
allfddkagklh	appreciation
allfladh	approach
allflfal	approval
allflfd	approve
allfllfkagd	appropriate
allflskjagdlh	approximately
allh	ally
allhd	alone
allhg	along
allhgskdd	alongside
allkahdd	alliance
allld	apple
alllh	apply
alllkdagklh	application
alllkhg	appoint
alllkhgjdhg	appointment
allllgkad	apologize
allls	allow
alsahs	always
alsl	also
as	as
asafd1	aware
asafd2	award
asafdhdss	awareness
asah	away
asakd	awake
asakg	await
asfjl	awful
asgflhljdf	astronomer
ash	ash
ask	ask
askah	asian
askdd	aside
aslddg	aspect
aslddl	asleep
ass	ass
assajlg	assault
assdfg	assert
assdg	asset
assdjgld	assemble
assdjglh	assembly
assdss	assess
assdssjdhg	assessment
assjfd	assure
assjjd	assume
assjjlgklh	assumption
asskgh	assign
asskghjdhg	assignment
assksg	assist
assksgahdd	assistance
assksgahg	assistant
assldkagd	associate
assldkagdd	associated
assldkagklh	association
d-jakl	e-mail
dad	dad
dadh	each
daf1	car
daf2	ear
dafd1	care
dafd2	card
dafd3	dare
dafd4	cave
dafddf	career
dafdfjl	careful
dafdfjllh	carefully
daffd	carve
daffh	carry
daffkdf	carrier
dafflg	carrot
dafg	cart
dafgh	earth
dafghajakd	earthquake
dafgl	cargo
dafglh	carbon
dafglhhdfagd	carbohydrate
dafgllh	cartoon
dafh	earn
dafhkhgs	earnings
dafk	dark
dafkhdss	darkness
dafldg	carpet
daflh	early
dag1	eat
dag2	cat
dag3	cab
daga	data
dagagasd	database
dagallg	catalog
dagd1	date
dagd2	cage
dagdf	eager
dagdglfh	category
dagdh	catch
daggld	cattle
daghllkd	catholic
dagkh	cabin
dagkhdg	cabinet
dagkhg	eating
dagld	cable
dah1	can
dah2	day
dahadkah	canadian
dahdd	dance
dahddf1	cancer
dahddf2	dancer
dahddl	cancel
dahdh	candy
dahdkdagd	candidate
dahdkhg	dancing
dahdld	candle
dahfas	canvas
dahgdf	danger
dahgdfljs	dangerous
daj	dam
dajagd	damage
dajagklh	equation
dajal	equal
dajalkgh	equality
dajallh	equally
dajdfa	camera
dajghgdf	daughter
dajh	damn
dajkfaldhg	equivalent
dajkgh	equity
dajkl	equip
dajkljdhg	equipment
dajl	camp
dajlakgh	campaign
dajljs	campus
dajsd	cause
dakd	cake
daklh	daily
dal	cap
daladkgh	capacity
dalagklkgh	capability
dalagld	capable
daldhdaf	calendar
daldjlagd	calculate
daldjlagklh	calculation
dalgakh	captain
dalgjfd	capture
dalj	calm
dalkgal	capital
dall	call
dasd1	case
dasd2	ease
dasg1	east
dasg2	cast
dasgdfh	eastern
dash1	easy
dash2	cash
dash3	dawn
dasjal	casual
dasjalgh	casualty
daskhl	casino
dasklh	easily
ddad	dead
ddadlh	deadly
ddadlkhd	deadline
ddaf	dear
ddagh	death
ddal	deal
ddaldf	dealer
ddasd	cease
dddadd	decade
ddddhg	decent
dddf	deer
dddfdasd	decrease
dddj	deem
dddk	deck
dddkdagd	dedicate
dddkdd	decide
dddksklh	decision
dddl	deep
dddlafd	declare
dddlfagd	decorate
dddlkhd	decline
dddllh	deeply
ddfasgagkhg	devastating
ddfdag	defeat
ddfdhd	defend
ddfdhdahg	defendant
ddfdhddf	defender
ddfdhsd	defense
ddfdhskfd	defensive
ddfdjlhh	ceremony
ddfdlll	develop
ddfdllldf	developer
ddfdllljdhg	development
ddfdllljdhgal	developmental
ddfdlllkhg	developing
ddfgakh	certain
ddfgakhlh	certainly
ddfkdd	device
ddfkdkg	deficit
ddfkfd	derive
ddfkhd	define
ddfkhkgdlh	definitely
ddfkhkgklh	definition
ddfkl	devil
ddflgd	devote
ddgagd	debate
ddgakl	detail
ddgakldd	detailed
ddgd	edge
ddgddg	detect
ddgddgkfd	detective
ddgdfjkhagklh	determination
ddgdfjkhd	determine
ddgfdd	degree
ddgfks	debris
ddgg	debt
ddgjg	debut
ddhgdf	center
ddhgfal	central
ddhgjfh	century
ddhh	deny
ddhkal	denial
ddhl	echo
ddhsd	dense
ddhskgh	density
ddjahd	demand
ddjdagd	educate
ddjdagklh	education
ddjdagklhal	educational
ddjdaglf	educator
ddjdgdfh	cemetery
ddjldfadh	democracy
ddjldfag	democrat
ddjldfagkd	democratic
ddjlgfalhkd	demographic
ddjlhsgfagd	demonstrate
ddjlhsgfagklh	demonstration
ddkg	edit
ddkgklh	edition
ddkglf	editor
ddklkhg	ceiling
ddl	ceo
ddlafg	depart
ddlafgjdhg	department
ddlafgjfd	departure
ddlah	delay
ddldgfagd	celebrate
ddldgfagklh	celebration
ddldgfkgh	celebrity
ddldhd	depend
ddldhddhg	dependent
ddldhdkhg	depending
ddlfdssdd	depressed
ddlfdssklh	depression
ddlgh	depth
ddlhljh	economy
ddlhljkd	economic
ddlhljkdallh	economically
ddlhljkds	economics
ddlhljksg	economist
ddljgh	deputy
ddlkdagd	delicate
ddlkdg	depict
ddlkfdf	deliver
ddlkfdfh	delivery
ddlkgdfagdlh	deliberately
ddlkghg	delight
ddll	cell
ddlllgkdal	ecological
ddlllh	deploy
ddllskg	deposit
ddlshsgdj	ecosystem
ddsddhd	descend
ddsdffd	deserve
ddsdfg	desert
ddsdfkgd	describe
ddsdfklgklh	description
ddsgfjdgklh	destruction
ddsgflh	destroy
ddsgkhagklh	destination
ddsk	desk
ddskfd	desire
ddskgh	design
ddskghdf	designer
ddsldfagd	desperate
ddsldfagdlh	desperately
ddslkgd	despite
ddssdfg	dessert
dfa	era
dfaah	crazy
dfadk	crack
dfafg1	draft
dfafg2	craft
dfag	drag
dfaja	drama
dfajagkd	dramatic
dfajagkdallh	dramatically
dfakh	drain
dfaljagd	evaluate
dfaljagklh	evaluation
dfas	draw
dfasdf	drawer
dfash	crash
dfaskhg	drawing
dfasl	crawl
dfdagd	create
dfdagjfd	creature
dfdagkfd	creative
dfdagkfkgh	creativity
dfdagklh	creation
dfdaj1	dream
dfdaj2	cream
dfddkg	credit
dfddkgklkgh	credibility
dfdf	ever
dfdfh	every
dfdfhdah	everyday
dfdfhghkhg	everything
dfdfhgldh	everybody
dfdfhlhd	everyone
dfdfhshdfd	everywhere
dfdh	even
dfdhg	event
dfdhgjallh	eventually
dfdhkhg	evening
dfds	crew
dfdss	dress
dffddg	effect
dffddgkfd	effective
dffddgkfdhdss	effectiveness
dffddgkfdlh	effectively
dffkdkdhdh	efficiency
dffkdkdhg	efficient
dfflf	error
dfflfg	effort
dfh1	cry
dfh2	dry
dfhsgal	crystal
dfjdkal	crucial
dfjdl	cruel
dfjg	drug
dfjhk	drunk
dfjj	drum
dfjksd	cruise
dfjsh	crush
dfkdd	dried
dfkddhdd	evidence
dfkddhg	evident
dfkfd	drive
dfkfdf	driver
dfkfdsah	driveway
dfkfg	drift
dfkfkhg	driving
dfkgdfka	criteria
dfkgkd	critic
dfkgkdal	critical
dfkgkdkad	criticize
dfkgkdksj	criticism
dfkhk	drink
dfkhkkhg	drinking
dfkjd	crime
dfkjkhal	criminal
dfkl	evil
dfkll	drill
dfksks	crisis
dfll1	drop
dfll2	crop
dfllfd	evolve
dflljgklh	evolution
dflsd	crowd
dflsddd	crowded
dflsh	drown
dflss	cross
dgd	etc
dgg	egg
dghhkd	ethnic
dghkdal	ethical
dghkds	ethics
dgl	ego
dha	dna
dhadg	enact
dhafadgdf	character
dhafadgdfkad	characterize
dhafadgdfksgkd	characteristic
dhafg	chart
dhafgd	charge
dhafgdf	charter
dhafj	charm
dhafkgh	charity
dhagld	enable
dhahdd	chance
dhahgd	change
dhahgkhg	changing
dhahhdl	channel
dhajgdf	chamber
dhajlklh	champion
dhajlklhshkl	championship
dhakf	chair
dhakfjah	chairman
dhakh	chain
dhalgdf	chapter
dhalldhgd	challenge
dhals	chaos
dhasd	chase
dhd1	eye
dhd2	end
dhdag	cheat
dhdal	cheap
dhddf	cheer
dhddk1	check
dhddk2	cheek
dhddsd	cheese
dhdf	chef
dhdfgh	energy
dhdgfls	eyebrow
dhdjfd	endure
dhdjh	enemy
dhdjkdal	chemical
dhdjksgfh	chemistry
dhdld	cycle
dhdldss	endless
dhdlfsd	endorse
dhdljfagd	encourage
dhdljfagkhg	encouraging
dhdljhgdf	encounter
dhds	chew
dhdsg	chest
dhfdllld	envelope
dhfkflhjdhg	environment
dhfkflhjdhgal	environmental
dhfksgjas	christmas
dhfksgkah	christian
dhfksgkahkgh	christianity
dhfksklh	envision
dhflfdd	enforce
dhflfddjdhg	enforcement
dhflhkd	chronic
dhflll	enroll
dhgagd	engage
dhgagdjdhg	engagement
dhgdf	enter
dhgdfgakhjdhg	entertainment
dhgdflfksd	enterprise
dhgfahdd	entrance
dhgfdlfdhdjf	entrepreneur
dhgfh	entry
dhghjskasj	enthusiasm
dhgkfd	entire
dhgkfdlh	entirely
dhgkgh	entity
dhgkgld	entitle
dhgkhd	engine
dhgkhddf	engineer
dhgkhddfkhg	engineering
dhglksh	english
dhhahdd	enhance
dhhajkd	dynamic
dhhajkds	dynamics
dhjfdh	church
dhjhk	chunk
dhjlh	enjoy
dhkdf	chief
dhkdkdh	chicken
dhkh	chin
dhkhdsd	chinese
dhkhg	dying
dhkl	chip
dhkld	child
dhkldhlld	childhood
dhkll	chill
dhldllagd	chocolate
dhlfjljs	enormous
dhljgh	enough
dhlkdd	choice
dhll	chop
dhlldsgdfll	cholesterol
dhllsd	choose
dhsjfd	ensure
djd1	due
djd2	cue
djdfgd	emerge
djdfgdhdh	emergency
djdfgkhg	emerging
djdk	duck
djfd	cure
djffd	curve
djffdhdh	currency
djffdhg	current
djffdhglh	currently
djffkdjljj	curriculum
djfgakh	curtain
djfkhg	during
djfkljs	curious
djfklskgh	curiosity
djflldah	european
djg	cut
djgaffassdd	embarrassed
djgah	cuban
djgd	cute
djgdh	dutch
djgfadd	embrace
djgh	duty
djjg	dumb
djjl	dump
djkssklh	emission
djl	cup
djlgh	empty
djlgjfal	cultural
djlgjfd	culture
djlgklh	emotion
djlgklhal	emotional
djlgklhallh	emotionally
djlhaskad	emphasize
djlhasks	emphasis
djlkfd	empire
djlllh	employ
djlllhdd	employee
djlllhdf	employer
djlllhjdhg	employment
djsg	dust
djsgldh	custody
djsglj	custom
djsgljdf	customer
dkafh	diary
dkagdgds	diabetes
dkaghlsd	diagnose
dkaghlsks	diagnosis
dkajlhd	diamond
dkallgjd	dialogue
dkd	die
dkdg	diet
dkdgagd	dictate
dkfddg	direct
dkfddgklh	direction
dkfddglf	director
dkfddglh	directly
dkfdfsd	diverse
dkfdfskgh	diversity
dkfdjjsgahdd	circumstance
dkfdjkg	circuit
dkfdld	circle
dkffdf	differ
dkffdfdhdd	difference
dkffdfdhg	different
dkffdfdhglh	differently
dkffkdjlg	difficult
dkffkdjlgh	difficulty
dkfg	dirt
dkfgh	dirty
dkfkd	civic
dkfkdd	divide
dkfkhd	divine
dkfkl	civil
dkfklkaagklh	civilization
dkfklkah	civilian
dkfksklh	division
dkflfdd	divorce
dkg	dig
dkgafdggd	cigarette
dkgd	cite
dkgh	city
dkghdf	either
dkghg	eight
dkghgh	eighth
dkghkgh	dignity
dkgkadh	citizen
dkgkadhshkl	citizenship
dkgkgal	digital
dkhhdf	dinner
dkhkhg	dining
dkjdhsklh	dimension
dkjkhksh	diminish
dkl	dip
dkldjja	dilemma
dkllljag	diplomat
dkllljagkd	diplomatic
dksagfdd	disagree
dksagklkgh	disability
dksagldd	disabled
dksalldaf	disappear
dksalllkhgdd	disappointed
dksalllkhgjdhg	disappointment
dksasgdf	disaster
dksd	disc
dksdasd	disease
dksdfkjkhagklh	discrimination
dksdjss	discuss
dksdjssklh	discussion
dksdkllkhd	discipline
dksdlfdf	discover
dksdlfdfh	discovery
dksdljfagd	discourage
dksdljfsd	discourse
dksdljhg	discount
dksdllsd	disclose
dksgahdd	distance
dksgahg	distant
dksgfadg	distract
dksgfkdg	district
dksgfkgjgd	distribute
dksgfkgjgklh	distribution
dksgjfg	disturb
dksgjfgkhg	disturbing
dksgkhdg	distinct
dksgkhdgkfd	distinctive
dksgkhdgklh	distinction
dksgkhgjksh	distinguish
dksh	dish
dksjkss	dismiss
dksk	disk
dkslfddf	disorder
dksljgd	dispute
dksllah	display
dkssllfd	dissolve
dl	do
dladh1	coach
dladh2	dozen
dlag	coat
dlaglfagd	elaborate
dlah	clay
dlakj	claim
dlal	coal
dlalkgklh	coalition
dlasg	coast
dlasgal	coastal
dlass	class
dlassfllj	classroom
dlasskd	classic
dlasskdal	classical
dlasskfh	classify
dldaf	clear
dldaflh	clearly
dldah	clean
dldakhd	cocaine
dldd	code
dlddf	elder
dlddflh	elderly
dlddg	elect
dlddgfkd	electric
dlddgfkdal	electrical
dlddgfkdkgh	electricity
dlddgflhkd	electronic
dlddgflhkds	electronics
dlddgklh	election
dldfaglf	elevator
dldfdh	eleven
dldfk	clerk
dldgahg	elegant
dldgfkhd	doctrine
dldglf	doctor
dldjdhg	element
dldjdhgafh	elementary
dldjjdhg	document
dldjjdhgafh	documentary
dldk	dock
dldlhahg	elephant
dlfd1	core
dlfd2	cord
dlfdf	cover
dlfdfagd	coverage
dlffdd	coffee
dlffddg	correct
dlffddglh	correctly
dlffdlagklh	correlation
dlffdsllhddhg	correspondent
dlffjlgklh	corruption
dlffkdlf	corridor
dlfh	corn
dlfhdf	corner
dlfllfagd	corporate
dlfllfagklh	corporation
dlg1	dog
dlg2	dot
dlggagd	cottage
dlgglh	cotton
dlghkgkfd	cognitive
dlgls	elbow
dlhagd	donate
dlhagklh	donation
dlhdddd	concede
dlhddfg	concert
dlhddfh	concern
dlhddfhdd	concerned
dlhddfhkhg	concerning
dlhddhgfagd	concentrate
dlhddhgfagklh	concentration
dlhddjh	condemn
dlhddkfd	conceive
dlhddlg	concept
dlhddlgklh	conception
dlhdfdgd	concrete
dlhdjdg	conduct
dlhdkgklh	condition
dlhdljdd	conclude
dlhdljsklh	conclusion
dlhfdfdhdd	conference
dlhfdfg	convert
dlhfdfsagklh	conversation
dlhfdfsklh	conversion
dlhfdh	convey
dlhfdhgklh	convention
dlhfdhgklhal	conventional
dlhfdhkdhdd	convenience
dlhfdss	confess
dlhfdssklh	confession
dlhfflhg	confront
dlhfflhgagklh	confrontation
dlhfjsd	confuse
dlhfjsklh	confusion
dlhfkddhdd	confidence
dlhfkddhg	confident
dlhfkdg	convict
dlhfkdgklh	conviction
dlhfkfj	confirm
dlhfkhdd	convince
dlhfkhddd	convinced
dlhflkdg	conflict
dlhgadg	contact
dlhgakh	contain
dlhgakhdf	container
dlhgdhd	contend
dlhgdhg	content
dlhgdjllagd	contemplate
dlhgdjllfafh	contemporary
dlhgdsg1	context
dlhgdsg2	contest
dlhgfadg	contract
dlhgfadglf	contractor
dlhgfasg	contrast
dlhgfdss	congress
dlhgfdssklhal	congressional
dlhgfkgjgd	contribute
dlhgfkgjgklh	contribution
dlhgfkgjglf	contributor
dlhgflfdfsh	controversy
dlhgflfdfskal	controversial
dlhgfll	control
dlhgkhdhg	continent
dlhgkhjd	continue
dlhgkhjdd	continued
dlhgkhjkhg	continuing
dlhgkhjljs	continuous
dlhhddg	connect
dlhhddgklh	connection
dlhlf	donor
dlhsdajdhdd	consequence
dlhsdajdhglh	consequently
dlhsddjgkfd	consecutive
dlhsdffagkfd	conservative
dlhsdffagklh	conservation
dlhsdhg	consent
dlhsdhsjs	consensus
dlhsdkdhdd	conscience
dlhsdkljs	conscious
dlhsdkljshdss	consciousness
dlhsgahg	constant
dlhsgahglh	constantly
dlhsgfakhg	constraint
dlhsgfjdg	construct
dlhsgfjdgklh	construction
dlhsgkgjgd	constitute
dlhsgkgjgklh	constitution
dlhsgkgjgklhal	constitutional
dlhsjjd	consume
dlhsjjdf	consumer
dlhsjjlgklh	consumption
dlhsjlg	consult
dlhsjlgahg	consultant
dlhskddf	consider
dlhskddfagklh	consideration
dlhskddfagld	considerable
dlhskddfaglh	considerably
dlhsksg	consist
dlhsksgdhg	consistent
dlhsksgdhglh	consistently
dlhslkfadh	conspiracy
dljakh	domain
dljd1	come
dljd2	clue
dljddh	comedy
dljdh	couch
dljdsgkd	domestic
dljfagd	courage
dljfg	court
dljfgfllj	courtroom
dljflfg	comfort
dljflfgagld	comfortable
dljfsd	course
dljg	club
dljgag	combat
dljgg	doubt
dljgh	dough
dljgkhagklh	combination
dljgkhd	combine
dljgkhdd	combined
dljgld	double
dljhdkl	council
dljhg	count
dljhgdf	counter
dljhgdflafg	counterpart
dljhgfh	country
dljhgh	county
dljhsdl	counsel
dljhsdlkhg	counseling
dljhsdllf	counselor
dljjahd	command
dljjahddf	commander
dljjdfdkal	commercial
dljjdhg	comment
dljjjhkdagd	communicate
dljjjhkdagklh	communication
dljjjhkgh	community
dljjkg	commit
dljjkggdd	committee
dljjkgjdhg	commitment
dljjkssklh	commission
dljjkssklhdf	commissioner
dljjldkgh	commodity
dljjlh	common
dljjlhlh	commonly
dljkhagd	dominate
dljkhahg	dominant
dljkhg	coming
dljl	coup
dljlafagld	comparable
dljlafd	compare
dljlafkslh	comparison
dljlahh	company
dljlahklh	companion
dljld	could
dljldgd	compete
dljldgkgkfd	competitive
dljldgkgklh	competition
dljldgkglf	competitor
dljldhsagklh	compensation
dljldl	compel
dljldllkhg	compelling
dljlfdhdhskfd	comprehensive
dljlfksd	comprise
dljlfljksd	compromise
dljljgdf	computer
dljllakh	complain
dljllakhg	complaint
dljlld	couple
dljlldgd	complete
dljlldgdlh	completely
dljllds	complex
dljlldskgh	complexity
dljllh	comply
dljllhdhg	component
dljlljhd	compound
dljllkahdd	compliance
dljllkdagdd	complicated
dljllsd	compose
dljllskgklh	composition
dljsgdf	cluster
dljskh	cousin
dlkddjkd	epidemic
dlkdhg	client
dlkdk	click
dlkff	cliff
dlkgd	elite
dlkgkgld	eligible
dlkh	coin
dlkhg	cling
dlkhkd	clinic
dlkhkdal	clinical
dlkjagd	climate
dlkjg	climb
dlkjkhagd	eliminate
dlkl	clip
dlksldd	episode
dll	cop
dlld1	cold
dlld2	cope
dlldk	clock
dllf	door
dllfdkhagd	coordinate
dllfdkhaglf	coordinator
dllfsah	doorway
dllgh	cloth
dllghds	clothes
dllghkhg	clothing
dllh	copy
dlljd	cloud
dlljjh	column
dlljjhksg	columnist
dllk	cook
dllkkd	cookie
dllkkhg	cooking
dlll1	cool
dlll2	doll
dlllaf	collar
dlllaglfagklh	collaboration
dlllalsd	collapse
dllldagjd	colleague
dlllddg	collect
dlllddgkfd	collective
dlllddgklh	collection
dlllddglf	collector
dllldfagd	cooperate
dllldfagkfd	cooperative
dllldfagklh	cooperation
dllldgd	college
dlllf	color
dlllffjl	colorful
dlllhh	colony
dlllhkal	colonial
dllsd	close
dllsdd	closed
dllsdf	closer
dllsdg	closet
dllsdlh	closely
dllsdsg	closest
dls	cow
dlsd1	else
dlsd2	dose
dlsdshdfd	elsewhere
dlsg	cost
dlsgjjd	costume
dlsglh	costly
dlsh	down
dlshglsh	downtown
dsadg	exact
dsadglh	exactly
dsaj	exam
dsajkhagklh	examination
dsajkhd	examine
dsajlld	example
dsdald	escape
dsdddd	exceed
dsddjgd	execute
dsddjgkfd	executive
dsddjgklh	execution
dsddlg	except
dsddlgklh	exception
dsddlldhg	excellent
dsddsskfd	excessive
dsdfdksd	exercise
dsdhahgd	exchange
dsdjsd	excuse
dsdkgdd	excited
dsdkgdjdhg	excitement
dsdkgkhg	exciting
dsdljdd	exclude
dsdljskfd	exclusive
dsdljskfdlh	exclusively
dsgagd	estate
dsgaglksh	establish
dsgaglkshjdhg	establishment
dsgdfhal	external
dsgdhd	extend
dsgdhddd	extended
dsgdhg	extent
dsgdhskfd	extensive
dsgdhsklh	extension
dsgfa	extra
dsgfalfdkhafh	extraordinary
dsgfdjd	extreme
dsgfdjdlh	extremely
dsgkjagd	estimate
dsgkjagdd	estimated
dshajsg	exhaust
dshkgkg	exhibit
dshkgkgklh	exhibition
dskg	exit
dsksg	exist
dsksgdhdd	existence
dsksgkhg	existing
dslahd	expand
dslahsklh	expansion
dslddg	expect
dslddgagklh	expectation
dslddgdd	expected
dslddkallh	especially
dslddkgklh	expedition
dsldfg	expert
dsldfgksd	expertise
dsldfkdhdd	experience
dsldfkdhddd	experienced
dsldfkjdhg	experiment
dsldfkjdhgal	experimental
dsldhsd	expense
dsldhskfd	expensive
dslfdss	express
dslfdssklh	expression
dslgkd	exotic
dsllahagklh	explanation
dsllakh	explain
dsllfg	export
dsllkdkg	explicit
dsllldd	explode
dslllfagklh	exploration
dslllfd	explore
dslllkg	exploit
dslllsklh	explosion
dsllsd	expose
dsllsjfd	exposure
dssah	essay
dssdhdd	essence
dssdhgkal	essential
dssdhgkallh	essentially
fadaf	radar
fadagklh	vacation
fadd1	face
fadd2	race
fadd3	fade
faddkhd	vaccine
fadg	fact
fadglf	factor
fadglfh	factory
fadjjj	vacuum
fadjlgh	faculty
fadk	rack
fadkagklh	radiation
fadkal	racial
fadkdal	radical
fadkl	radio
fadklkgagd	facilitate
fadklkgh	facility
fadksj	racism
faf	far
fafd1	rare
fafd2	fare
fafdlh	rarely
fafh	vary
fafj	farm
fafjdf	farmer
fafkagklh	variation
fafkagld	variable
fafkdgh	variety
fafkljs	various
faflf	favor
faflfagld	favorable
faflfkgd	favorite
fag1	fat
fag2	rat
fagal	fatal
fagd1	rate
fagd2	fate
fagd3	rage
fagfkd	fabric
faggkg	rabbit
faghdf1	father
faghdf2	rather
fagkgjd	fatigue
fagkhg	rating
fagkl	ratio
fagklhal	rational
fah1	fan
fah2	van
fahdh	ranch
fahdlj	random
fahgasgkd	fantastic
fahgash	fantasy
fahgd	range
fahk	rank
fahksh	vanish
fajd	fame
fajklh	family
fajklkaf	familiar
fajlg	fault
fajljs	famous
fakf	fair
fakflh	fairly
fakgh	faith
fakh	rain
fakhg	faint
fakl1	fail
fakl2	rail
faklflad	railroad
fakljfd	failure
faksd	raise
fald	rape
faljagld	valuable
faljd	value
falkd1	rapid
falkd2	valid
falkdkgh	validity
falkdlh	rapidly
fall	fall
falldh	valley
fallh	rally
falsd	false
fas	raw
fasdkhagkhg	fascinating
fasg1	fast
fasg2	vast
fasgdf	faster
fashklh	fashion
fd	re
fdad	read
fdaddf	reader
fdadg	react
fdadgklh	reaction
fdadh1	reach
fdadh2	ready
fdadkhg	reading
fdadklh	readily
fdaf1	fear
fdaf2	rear
fdaghdf	feather
fdagjfd	feature
fdajdsg	request
fdajkfd	require
fdajkfdd	required
fdajkfdjdhg	requirement
fdal	real
fdalj	realm
fdalkad	realize
fdalkgh	reality
fdalksgkd	realistic
fdallh	really
fdaslh	reason
fdaslhagld	reasonable
fdd1	red
fdd2	fee
fddall	recall
fddd	feed
fdddfal	federal
fdddgadk	feedback
fdddhg	recent
fdddhglh	recently
fdddkfd	receive
fdddkfdf	receiver
fdddlgklh	reception
fdddssklh	recession
fddfjkg	recruit
fddjdd	reduce
fddjdgklh	reduction
fddkld	recipe
fddklkdhg	recipient
fddl	feel
fddlfd	record
fddlfdf	recover
fddlfdfh	recovery
fddlfdkhg	recording
fddlghkad	recognize
fddlghkgklh	recognition
fddljjdhd	recommend
fddljjdhdagklh	recommendation
fddlkhg	feeling
fdfdal	reveal
fdfdf1	refer
fdfdf2	fever
fdfdfdhdd	reference
fdfdfsd	reverse
fdfdhjd	revenue
fdfdkdg	verdict
fdfdlagklh	revelation
fdffkgdfaglf	refrigerator
fdfgal	verbal
fdfgkdal	vertical
fdfh	very
fdfjgd	refuge
fdfjgdd	refugee
fdfjsd	refuse
fdfkds	review
fdflddg	reflect
fdflddgklh	reflection
fdflfj	reform
fdflljgklh	revolution
fdflljgklhafh	revolutionary
fdfsjs	versus
fdfsklh	version
fdgafd	regard
fdgafdkhg	regarding
fdgafdldss	regardless
fdgakh1	retain
fdgakh2	regain
fdgakl	retail
fdgakldf	retailer
fdgdfah	veteran
fdgdgagld	vegetable
fdgdl	rebel
fdgfdag	retreat
fdgfdg	regret
fdgjfh	return
fdgjkld	rebuild
fdgjlaf	regular
fdgjlaflh	regularly
fdgjlagd	regulate
fdgjlagklh	regulation
fdgjlaglf	regulator
fdgjlaglfh	regulatory
fdgkfd	retire
fdgkfdd	retired
fdgkfdjdhg	retirement
fdgkjd	regime
fdgklh	region
fdgklhal	regional
fdgksgdf	register
fdhagklkgagklh	rehabilitation
fdhdd	fence
fdhddf	render
fdhdlf	vendor
fdhg	rent
fdhgal	rental
fdhgjfd	venture
fdhkdld	vehicle
fdjafk	remark
fdjafkagld	remarkable
fdjakh	remain
fdjakhkhg	remaining
fdjald	female
fdjddg	reject
fdjdjgdf	remember
fdjkhd	remind
fdjkhddf	reminder
fdjkhksg	feminist
fdjlfal	removal
fdjlfd	remove
fdjlgd	remote
fdkhflfdd	reinforce
fdlagd	relate
fdlagdd	related
fdlagkfd	relative
fdlagkfdlh	relatively
fdlagklh	relation
fdlagklhshkl	relationship
fdlakf	repair
fdlas	relax
fdldag	repeat
fdldagddlh	repeatedly
fdldasd	release
fdldfahg	relevant
fdlfdsdhg	represent
fdlfdsdhgagkfd	representative
fdlfdsdhgagklh	representation
fdlh	rely
fdljdgahg	reluctant
fdljgagklh	reputation
fdljglkd	republic
fdljglkdah	republican
fdlkagklkgh	reliability
fdlkagld	reliable
fdlkdf	relief
fdlkdfd	relieve
fdlkgklh	religion
fdlkgkljs	religious
fdlladd	replace
fdlladdjdhg	replacement
fdllfg	report
fdllfgddlh	reportedly
fdllfgdf	reporter
fdllfgkhg	reporting
fdllh	reply
fdllls	fellow
fds	few
fdsafd	reward
fdsdafdh	research
fdsdafdhdf	researcher
fdsdf	fewer
fdsdffagklh	reservation
fdsdffd	reserve
fdsdjd	rescue
fdsdjgld	resemble
fdsg	rest
fdsgajfahg	restaurant
fdsgfkdg	restrict
fdsgfkdgklh	restriction
fdsgkfal	festival
fdsglfd	restore
fdsjjd	resume
fdsjlg	result
fdskddhdd	residence
fdskddhg	resident
fdskddhgkal	residential
fdskgh	resign
fdsksg	resist
fdsksgahdd	resistance
fdslddg	respect
fdslddgkfdlh	respectively
fdslfg	resort
fdsljfdd	resource
fdsllfd	resolve
fdsllhd	respond
fdsllhddhg	respondent
fdsllhsd	response
fdsllhskgklkgh	responsibility
fdsllhskgld	responsible
fdslljgklh	resolution
fdssdl	vessel
ffadgklh	fraction
ffagjdhg	fragment
ffagkld	fragile
ffahdhksd	franchise
ffahklh	frankly
ffajd1	frame
ffajd2	fraud
ffajdslfk	framework
ffdajdhdh	frequency
ffdajdhg	frequent
ffdajdhglh	frequently
ffdd	free
ffddad	freeze
ffdddlj	freedom
ffddlh	freely
ffdhdh	french
ffdsh	fresh
ffdshjah	freshman
ffjkg	fruit
ffjsgfagd	frustrate
ffjsgfagklh	frustration
ffkdhd	friend
ffkdhdlh	friendly
ffkdhdshkl	friendship
ffladh	frozen
fflhg	front
fflhgkdf	frontier
fflj	from
fflsh	frown
fhdglfkd	rhetoric
fhhghj	rhythm
fjdkkhg	fucking
fjdl	fuel
fjf	fur
fjfal	rural
fjfghdfjlfd	furthermore
fjfhkgjfd	furniture
fjg	rub
fjggdf	rubber
fjgjfd	future
fjh1	run
fjh2	fun
fjhd	fund
fjhdajdhgal	fundamental
fjhdfal	funeral
fjhdgklh	function
fjhdgklhal	functional
fjhdkhg	funding
fjhhdf	runner
fjhhh	funny
fjhhkhg	running
fjjlf	rumor
fjkh	ruin
fjld	rule
fjlhdfagld	vulnerable
fjlkhg	ruling
fjll	full
fjll-gkjd	full-time
fjllh	fully
fjsh	rush
fjsskah	russian
fka	via
fkd	rid
fkdd1	ride
fkdd2	rice
fkddf	rider
fkddl	video
fkdfdd	fierce
fkdgd	ridge
fkdgkj	victim
fkdgklh	fiction
fkdglfh	victory
fkdh	rich
fkdkdjlljs	ridiculous
fkdld	field
fkds	view
fkdsdf	viewer
fkfal	rival
fkfd1	five
fkfd2	fire
fkfdf	river
fkfgddh	fifteen
fkfgh1	fifth
fkfgh2	fifty
fkfgjal	virtual
fkfgjallh	virtually
fkfgjd	virtue
fkfj	firm
fkfjlh	firmly
fkfjs	virus
fkfld	rifle
fkfsg	first
fkg1	fit
fkg2	rib
fkgajkh	vitamin
fkgal	vital
fkgdf	fiber
fkgglh	ribbon
fkghdss	fitness
fkghg1	right
fkghg2	fight
fkghgdf	fighter
fkghgkhg	fighting
fkgjal	ritual
fkgjfd	figure
fkhahdd	finance
fkhahdkal	financial
fkhal	final
fkhallh	finally
fkhd1	find
fkhd2	fine
fkhdkhg	finding
fkhg	ring
fkhgdf	finger
fkhksh	finish
fkj	rim
fkl	rip
fkld	file
fklg	riot
fklgdf	filter
fklj	film
fkll	fill
fkllagd1	village
fkllagd2	violate
fkllagklh	violation
fklldhdd	violence
fklldhg	violent
fks	fix
fksd	rise
fksdal	fiscal
fksdd	fixed
fksg	fist
fksh	fish
fkshdfjah	fisherman
fkshkhg	fishing
fksjal	visual
fksk	risk
fkskg	visit
fkskgld	visible
fkskglf	visitor
fkskh	risky
fksklh	vision
flad	road
flaflf	flavor
flag1	flag
flag2	flat
flajd	flame
flash	flash
fld	rod
fldal	vocal
fldd	flee
flddg	fleet
fldjs	focus
fldk	rock
fldkdg	rocket
fldsh	flesh
fldskgklkgh	flexibility
fldskgld	flexible
flf	for
flfdd	force
flfdfdf	forever
flfdhdad	forehead
flfdkgh	foreign
flfdkghdf	foreigner
flfdsg	forest
flfgdg	forget
flfgh1	forth
flfgh2	forty
flfgjhagdlh	fortunately
flfgjhd	fortune
flfgkd	forbid
flfgkfd	forgive
flfj	form
flfjag	format
flfjagklh	formation
flfjal	formal
flfjdf	former
flfjdflh	formerly
flfjj	forum
flfjjla	formula
flfk	fork
flfsafd	forward
flg	fog
flgd	vote
flgdf	voter
flgkhg	voting
flglg	robot
flh	fly
flhal	royal
flhkhg	flying
fljah	roman
fljahdd	romance
fljahgkd	romantic
fljf	four
fljfgh	fourth
fljgd	route
fljgh	rough
fljghlh	roughly
fljgkhd	routine
fljgkhdlh	routinely
fljhd1	round
fljhd2	found
fljhdagklh	foundation
fljhddf	founder
fljkd	fluid
flkdd	voice
flkghg	flight
flkl	flip
fllag	float
flld1	food
flld2	role
flld3	rope
flld4	fold
fllf	roof
fllg1	foot
fllg2	root
fllggall	football
fllj	room
flljf	flour
flljhgafh	voluntary
flljhgddf	volunteer
flljjd	volume
fllk	folk
flll1	roll
flll2	fool
fllld	flood
flllf	floor
flllkhg	rolling
flllls	follow
fllllskhg	following
flls	flow
fllsdf	flower
fls	row
flsd	rose
flsgdf	foster
fs	vs
g-shkfg	t-shirt
gaad	gaze
gad	bad
gadgdfka	bacteria
gadgkd	tactic
gadk	back
gadkgfljhd	background
gadkhafd	backyard
gadkld	tackle
gadlh	badly
gaf	bar
gafagd	garage
gafd	bare
gafddh	garden
gafdlh	barely
gaffdl	barrel
gaffkdf	barrier
gafgagd	garbage
gafgdg	target
gafh	barn
gaflkd	garlic
gag1	bag
gag2	bat
gag3	tag
gagd	gate
gaggdfh	battery
gaggld	battle
gagh1	baby
gagh2	bath
gaghdf	gather
gaghdfkhg	gathering
gaghfllj	bathroom
gagld	table
gagldslllh	tablespoon
gah1	gay
gah2	ban
gah3	bay
gahaha	banana
gahd	band
gahg	gang
gahk1	bank
gahk2	tank
gahkdf	banker
gahkfjlgdh	bankruptcy
gahkkhg	banking
gajd	game
gakd1	take
gakd2	bake
gakh	gain
gakl	tail
gal1	gap
gal2	tap
galahdd	balance
galahddd	balanced
galash	galaxy
gald1	tape
gald2	tale
galdhg	talent
galdhgdd	talented
galk	talk
gall1	ball
gall2	tall
galldfh	gallery
galllg	ballot
gallllh	balloon
gas1	tax
gas2	gas
gasd	base
gasdgall	baseball
gasdjdhg	basement
gasgd	taste
gask	task
gaskd	basic
gaskdallh	basically
gaskdg	basket
gaskdggall	basketball
gasks	basis
gaslahdf	taxpayer
gasllkhd	gasoline
gd	be
gda	tea
gdadh1	teach
gdadh2	beach
gdadhdf	teacher
gdadhkhg	teaching
gdaf1	bear
gdaf2	tear
gdaf3	gear
gdafd	beard
gdag	beat
gdah	bean
gdaj1	team
gdaj2	beam
gdajgh	beauty
gdajgkfjl	beautiful
gdajjagd	teammate
gdasg	beast
gdaslllh	teaspoon
gdd1	bed
gdd2	bee
gddajsd	because
gddf1	beer
gddf2	beef
gddfllj	bedroom
gddh	teen
gddhagd	teenage
gddhagdf	teenager
gddhhkajd	technique
gddhhkdal	technical
gddhhkdkah	technician
gddhhlllgh	technology
gddhhlllgkdal	technological
gddljd	become
gdffakh	terrain
gdffkfkd	terrific
gdffkgld	terrible
gdffkglfh	territory
gdffkglh	terribly
gdfflf	terror
gdfflfksg	terrorist
gdfflfksj	terrorism
gdfj	term
gdfjah	german
gdfjs	terms
gdflfd	before
gdg1	get
gdg2	bet
gdg3	beg
gdggdf	better
gdgkh	begin
gdgkhhkhg	beginning
gdgsddh	between
gdh	ten
gdhafd	behave
gdhafklf	behavior
gdhafklfal	behavioral
gdhalf	behalf
gdhd1	tend
gdhd2	bend
gdhd3	gene
gdhdagh	beneath
gdhddf1	gender
gdhddf2	tender
gdhddhdh	tendency
gdhdfagd	generate
gdhdfagklh	generation
gdhdfal	general
gdhdfallh	generally
gdhdfkg	benefit
gdhdfljs	generous
gdhdgkd	genetic
gdhdh	bench
gdhfd	genre
gdhg	tent
gdhgld	gentle
gdhgldjah	gentleman
gdhglh	gently
gdhhks	tennis
gdhjkhd	genuine
gdhkhd	behind
gdhkjs	genius
gdhlhd	beyond
gdhsklh	tension
gdjldfagjfd	temperature
gdjlld	temple
gdjllfafh	temporary
gdkhg	being
gdldfksklh	television
gdldlhlhd	telephone
gdldsdlld	telescope
gdlg	belt
gdlkdf	belief
gdlkdfd	believe
gdll1	tell
gdll2	bell
gdllh	belly
gdllhg	belong
gdlls	below
gdsg1	best
gdsg2	test
gdsg3	text
gdsggllk	textbook
gdsgjfd1	gesture
gdsgjfd2	texture
gdsgkfh	testify
gdsgkhg	testing
gdsgkjlhh	testimony
gdskdd	beside
gdskdds	besides
gf	tv
gfadd1	trade
gfadd2	grade
gfadd3	trace
gfadd4	grace
gfadjagd	graduate
gfadjagklh	graduation
gfadjallh	gradually
gfadk	track
gfadkgklh	tradition
gfadkgklhal	traditional
gfadkgklhallh	traditionally
gfadkhg	trading
gfafd1	grave
gfafd2	brave
gfafdl	travel
gfafdldf	traveler
gfaffkd	traffic
gfafkgh	gravity
gfag	grab
gfagddh	tragedy
gfagdfjl	grateful
gfagkd	tragic
gfah1	gray
gfah2	tray
gfahd1	grand
gfahd2	brand
gfahddhkld	grandchild
gfahdfaghdf	grandfather
gfahdh	branch
gfahdjlghdf	grandmother
gfahdlafdhg	grandparent
gfahg	grant
gfahsadgklh	transaction
gfahsfdf	transfer
gfahsflfj	transform
gfahsflfjagklh	transformation
gfahsjkg	transmit
gfahsjkssklh	transmission
gfahskg	transit
gfahskgklh	transition
gfahslagd	translate
gfahslagklh	translation
gfahsllfg	transport
gfahsllfgagklh	transportation
gfajja	trauma
gfakd	brake
gfakg	trait
gfakh1	brain
gfakh2	train
gfakh3	grain
gfakhdf	trainer
gfakhkhg	training
gfakl	trail
gfakldf	trailer
gfal	trap
gfald	grape
gfash	trash
gfasl	grasp
gfass	grass
gfdad	bread
gfdag1	great
gfdag2	treat
gfdagdsg	greatest
gfdagh1	breath
gfdagh2	treaty
gfdaghd	breathe
gfdaghkhg	breathing
gfdagjdhg	treatment
gfdaglh	greatly
gfdak	break
gfdakfasg	breakfast
gfdasg	breast
gfdasjfd	treasure
gfdd	tree
gfddad	breeze
gfddg	greet
gfddh	green
gfddk	greek
gfdhd	trend
gfdjdhdljs	tremendous
gfh	try
gfjd	true
gfjdk	truck
gfjgal	brutal
gfjgh	truth
gfjhk	trunk
gfjlh	truly
gfjsg	trust
gfjsh	brush
gfkal	trial
gfkdd	bride
gfkdf1	brief
gfkdf2	grief
gfkdflh	briefly
gfkdgd	bridge
gfkdk1	trick
gfkdk2	brick
gfkgal	tribal
gfkgd	tribe
gfkggdf	trigger
gfkghg	bright
gfkgksh	british
gfkh	grin
gfkhg	bring
gfkj	trim
gfkjjlh	triumph
gfkl1	trip
gfkl2	grip
gfkllkahg	brilliant
gflad	broad
gfladdasg	broadcast
gflddfh	grocery
gflghdf	brother
gflhad	bronze
gfljgld	trouble
gfljgldd	troubled
gfljhd	ground
gfljl	group
gflkdf	broker
gflkdh	broken
gfllkdal	tropical
gflll	troop
gfls	grow
gflsgh	growth
gflsh	brown
gflskhg	growing
gflss	gross
gh	by
ghag	that
ghah	than
ghahk	thank
ghahks	thanks
ghahksgkfkhg	thanksgiving
ghd	the
ghdagdf	theater
ghdfalh	therapy
ghdfalksg	therapist
ghdfd	there
ghdfdflfd	therefore
ghdfdgh	thereby
ghdh1	they
ghdh2	then
ghdj	them
ghdjd	theme
ghdjsdlfds	themselves
ghdkf	their
ghdlfdgkdal	theoretical
ghdlfh	theory
ghdlllgh	theology
ghdlllgkdal	theological
ghdsd	these
ghfdad	thread
ghfdag	threat
ghfdagdh	threaten
ghfdd	three
ghfdshlld	threshold
ghfkfd	thrive
ghflag	throat
ghfljgh	through
ghfljghljg	throughout
ghfls	throw
ghj	gym
ghjjg	thumb
ghjs	thus
ghkdk	thick
ghkfd	third
ghkfgh	thirty
ghkgh	thigh
ghkh	thin
ghkhg	thing
ghkhk	think
ghkhkkhg	thinking
ghks	this
ghld	type
ghlfljghlh	thoroughly
ghljgh	though
ghljghg	thought
ghljsahd	thousand
ghlkdal	typical
ghlkdallh	typically
ghlsd	those
ghlsg	ghost
gjafahgdd	guarantee
gjafd	guard
gjddh	buddy
gjdgdg	budget
gjdk1	buck
gjdk2	tuck
gjdkdg	bucket
gjdsg	guest
gjdss	guess
gjfdaj	bureau
gjfddh	burden
gjfh1	turn
gjfh2	burn
gjfh3	bury
gjfhkhg	burning
gjfkdh	turkey
gjg1	but
gjg2	bug
gjg3	gut
gjgd	tube
gjgg	butt
gjggdf	butter
gjggdfflh	butterfly
gjggld	bubble
gjgglh	button
gjh1	guy
gjh2	buy
gjh3	gun
gjhd	tune
gjhdf	buyer
gjhdh	bunch
gjhhdl	tunnel
gjjlf	tumor
gjkdahdd	guidance
gjkdd	guide
gjkddlkhd	guideline
gjkgaf	guitar
gjkld	build
gjklddf	builder
gjkldkhg	building
gjklg	guilt
gjklgh	guilty
gjlg	bulb
gjlk	bulk
gjll	bull
gjlldg	bullet
gjs	bus
gjsh1	busy
gjsh2	bush
gjskhdss	business
gjskhdssjah	businessman
gkahg	giant
gkas	bias
gkd1	tie
gkd2	bid
gkdd	tide
gkdhdld	bicycle
gkdkdg	ticket
gkfd1	give
gkfd2	bird
gkfd3	tire
gkfdd	tired
gkfdh	given
gkfg	gift
gkfgdd	gifted
gkfgh	birth
gkfghdah	birthday
gkfl	girl
gkflffkdhd	girlfriend
gkg1	big
gkg2	bit
gkgd	bite
gkggdf	bitter
gkghg	tight
gkghgdh	tighten
gkghglh	tightly
gkgld1	title
gkgld2	bible
gkhd	bind
gkhh	tiny
gkjd	time
gkjgdf	timber
gkjkhg	timing
gkkd	bike
gkl	tip
gkld	tile
gklgfalhh	biography
gkll1	bill
gkll2	till
gkllklh	billion
gklllgh	biology
gklllgkdal	biological
gkshll	bishop
gkssjd	tissue
gl1	to
gl2	go
glad	glad
gladd	blade
gladk	black
glafd	board
glag1	boat
glag2	goat
glahdd	glance
glahk	blank
glahkdg	blanket
glajd	blame
glal	goal
glasg1	boast
glasg2	blast
glass	glass
gld1	god
gld2	toe
gldah	today
gldh	body
gldhd	blend
gldss	bless
gldsskhg	blessing
glfddf	border
glfdfh	govern
glfdfhjdhg	government
glfdfhlf	governor
glffls	borrow
glfh	born
glfkhg	boring
glgaddl	tobacco
glgal	total
glgallh	totally
glgdghdf	together
glggld	bottle
glgglj	bottom
glgh	both
glghdf	bother
glh1	boy
glh2	toy
glhd1	bone
glhd2	bond
glhd3	tone
glhffkdhd	boyfriend
glhgjd	tongue
glhjs	bonus
glhkghg	tonight
gljagl	tomato
gljd	blue
gljdh	touch
gljdhdlsh	touchdown
gljf	tour
gljfhajdhg	tournament
gljfksg	tourist
gljfksj	tourism
gljg	bomb
gljgh	tough
gljgkhg	bombing
gljhdafh	boundary
gljhdd	bounce
gljlffls	tomorrow
glkhd	blind
glkhk	blink
glkjlsd	glimpse
glkl	boil
glkldg	toilet
gll1	too
gll2	top
glld1	good
glld2	gold
glld3	bold
gllddh	golden
glldfagd	tolerate
glldfahdd	tolerance
glldk	block
gllf	golf
gllfd	glove
gllfh	glory
gllg1	boot
gllg2	bolt
gllgal	global
gllgd	globe
gllgh1	tooth
gllgh2	booth
gllhd	blond
gllj	boom
gllk	book
gllkd	topic
glll1	tool
glll2	toll
gllld	blood
gllldh	bloody
glls	blow
gllsg	boost
gls1	box
gls2	bow
glsafd	toward
glsafds	towards
glsdf	tower
glsdl	towel
glsh	town
glskd	toxic
glsl	bowl
glss1	boss
glss2	toss
gsdhgh	twenty
gsdhgkdgh	twentieth
gsdlfd	twelve
gskdd	twice
gskh	twin
gsksg	twist
gsl	two
gsl-ghkfds	two-thirds
ha	ha
haaafd	hazard
hafassjdhg	harassment
hafd1	have
hafd2	hard
hafd3	yard
hafdlh	hardly
hafdsafd	hardware
haffagkfd	narrative
haffdsg	harvest
haffls	narrow
hafj	harm
hafjlhh	harmony
hafsh	harsh
hag	hat
hagd	hate
hagjfal	natural
hagjfallh	naturally
hagjfd	nature
hagkfd	native
hagkg	habit
hagkgag	habitat
hagklh	nation
hagklhal	national
hagklhskdd	nationwide
hah	hay
hahd	hand
hahdfjl	handful
hahdld	handle
hahdsljd	handsome
hahg	hang
hajd	name
hajl	haul
hakdd	naked
hakf	hair
hakl	nail
half	half
halfsah	halfway
hall	hall
halldh	happen
hallh	happy
hallkhdss	happiness
hallklh	happily
hallsah	hallway
hasgh	nasty
hd	he
hdad	head
hdadadhd	headache
hdadajafgdfs	headquarters
hdadlkhd	headline
hdaf1	year
hdaf2	hear
hdaf3	near
hdafdh	heaven
hdafg	heart
hdafgh	nearby
hdafh	heavy
hdafkhg	hearing
hdafklh	heavily
hdaflh	nearly
hdag1	heat
hdag2	neat
hdah	yeah
hdal	heal
hdalgh	health
hdalgh-dafd	health-care
hdalghh	healthy
hddd	need
hdddld	needle
hdddssafh	necessary
hdddssafklh	necessarily
hdddsskgh	necessity
hddk	neck
hddl	heel
hdf	her
hdfd	here
hdfdf	never
hdfdfghdldss	nevertheless
hdffd	nerve
hdffljs	nervous
hdfg	herb
hdfkgagd	heritage
hdfl	hero
hdfs	hers
hdfsdlf	herself
hdg1	yet
hdg2	net
hdgagkfd	negative
hdglgkagd	negotiate
hdglgkagklh	negotiation
hdgslfk	network
hdh	hey
hdhdd	hence
hdjgfal	neutral
hdkghdf	neither
hdkghg	height
hdkghglf	neighbor
hdkghglfhlld	neighborhood
hdkghglfkhg	neighboring
hdljdg	helmet
hdlkdllgdf	helicopter
hdll1	help
hdll2	hell
hdll3	yell
hdllfjl	helpful
hdlll	hello
hdllls	yellow
hds1	new
hds2	yes
hdsg1	next
hdsg2	nest
hdsgdfdah	yesterday
hdskgagd	hesitate
hdslh	newly
hdss	news
hdsslaldf	newspaper
hhllghdsks	hypothesis
hjdldaf	nuclear
hjffh	hurry
hjffkdahd	hurricane
hjfg	hurt
hjfsd	nurse
hjg1	nut
hjg2	hug
hjgd	huge
hjgfkdhg	nutrient
hjh	huh
hjhdfdd	hundred
hjhg	hunt
hjhgdf1	hunter
hjhgdf2	hunger
hjhgfh	hungry
hjhgkhg	hunting
hjjah	human
hjjahkgh	humanity
hjjdfljs	numerous
hjjgdf	number
hjjlf	humor
hjsgahd	husband
hk	hi
hkdd1	nice
hkdd2	hide
hkdddh	hidden
hkdld	yield
hkfd	hire
hkg	hit
hkgh	high
hkgh-gddh	high-tech
hkghg	night
hkghgjafd	nightmare
hkghlh	highly
hkghlkghg	highlight
hkghsah	highway
hkhd	nine
hkhg	hint
hkj	him
hkjsdlf	himself
hkkd	hike
hkl	hip
hkll	hill
hks	his
hksglfh	history
hksglfkah	historian
hksglfkd	historic
hksglfkdal	historical
hksglfkdallh	historically
hkslahkd	hispanic
hl	no
hld	nod
hldkdh	hockey
hlf	nor
hlfdl	novel
hlffkgld	horrible
hlfflf	horror
hlfgh	north
hlfghdasg	northeast
hlfghdfh	northern
hlfghsdsg	northwest
hlfh	horn
hlfj	norm
hlfjal	normal
hlfjallh	normally
hlfjlhd	hormone
hlfkalh	horizon
hlfsd	horse
hlg1	not
hlg2	hot
hlgd	note
hlgdgllk	notebook
hlgdl	hotel
hlghkhg	nothing
hlgkdd	notice
hlgklh	notion
hlgldh	nobody
hlhd	none
hlhdghdldss	nonetheless
hlhdh	honey
hlhdsg	honest
hlhdsglh	honestly
hlhlf	honor
hlhlflfkg	nonprofit
hlj	you
hljd	home
hljdlahd	homeland
hljdldss	homeless
hljdslfk	homework
hljf1	your
hljf2	hour
hljfs	yours
hljfsdlf	yourself
hljgh	youth
hljhg	young
hljhgsgdf	youngster
hljkhagklh	nomination
hljkhdd	nominee
hljsd	house
hljsdhlld	household
hljskhg	housing
hlksd	noise
hlld1	hold
hlld2	hope
hlld3	hole
hlldfjllh	hopefully
hllh1	holy
hllh2	noon
hllk	hook
hllkdah	holiday
hls1	now
hls2	how
hlsd	nose
hlsdfdf	however
hlsg	host
hlsgagd	hostage
hlsgkld	hostile
hlshdfd	nowhere
hlslkgal	hospital
jaaa	jazz
jad	mad
jadhkhd	machine
jadkdg	jacket
jaf	jar
jafdh	march
jaffh	marry
jaffkagd	marriage
jaffkdd	married
jafgkh	margin
jafgld	marble
jafk	mark
jafkdf	marker
jafkdg	market
jafkdgkhg	marketing
jafkdglladd	marketplace
jafkhd	marine
jagaakhd	magazine
jagd	mate
jagdfkal	material
jagdh	match
jaggdf	matter
jagh	math
jaghdgkd	magnetic
jaghdjagkds	mathematics
jaghkgjdd	magnitude
jagkd	magic
jah1	man
jah2	may
jahagd	manage
jahagdf	manager
jahagdjdhg	management
jahagkhg	managing
jahdagd	mandate
jahgd	maybe
jahh	many
jahhdf	manner
jahjfadgjfdf	manufacturer
jahjfadgjfkhg	manufacturing
jahkljlagd	manipulate
jahlf	mayor
jahsklh	mansion
jajlf	major
jajlfkgh	majority
jakd	make
jakdf	maker
jakdjl	makeup
jakh	main
jakhgakh	maintain
jakhgdhahdd	maintenance
jakhlh	mainly
jakhsgfdaj	mainstream
jakl1	mail
jakl2	jail
jal	map
jalahdsd	japanese
jald	male
jall	mall
jas	jaw
jasgdf	master
jask	mask
jaskjjj	maximum
jass	mass
jasskfd	massive
jd	me
jdag	meat
jdah	mean
jdahgkjd	meantime
jdahkhg	meaning
jdahkhgfjl	meaningful
jdahs	jeans
jdahshkld	meanwhile
jdal	meal
jdasjfd	measure
jdasjfdjdhg	measurement
jddal	medal
jddg	meet
jddgkhg	meeting
jddhahkd	mechanic
jddhahkdal	mechanical
jddhahksj	mechanism
jddka	media
jddkdagklh	medication
jddkdal	medical
jddkdkhd	medicine
jddkjj	medium
jdfd	mere
jdfdhahg	merchant
jdfdlh	merely
jdfkg	merit
jdg	jet
jdgal	metal
jdgalhlf	metaphor
jdgdf	meter
jdgfllllkgah	metropolitan
jdghld	method
jdhgal	mental
jdhgallh	mentally
jdhgklh	mention
jdhglf	mentor
jdhj	menu
jdjgdf	member
jdjgdfshkl	membership
jdjlfh	memory
jdlg	melt
jds	jew
jdsdlfh	jewelry
jdskdah	mexican
jdsksh	jewish
jdss	mess
jdssagd	message
jf	mr
jfgah	urban
jfgd	urge
jfs	mrs
jgklkad	utilize
jgklkgh	utility
jglh	ugly
jh1	my
jh2	uh
jhagld	unable
jhddf	under
jhddfgakd	undertake
jhddfgakh	uncertain
jhddfgakhgh	uncertainty
jhddfgfadjagd	undergraduate
jhddfgl	undergo
jhddfjkhd	undermine
jhddflhkhg	underlying
jhddfsgahd	understand
jhddfsgahdkhg	understanding
jhdjlllhjdhg	unemployment
jhdld	uncle
jhdlfdf	uncover
jhdljflfgagld	uncomfortable
jhdslddgdd	unexpected
jhfakf	unfair
jhflfgjhagdlh	unfortunately
jhflld	unfold
jhgh	myth
jhgkl	until
jhhallh	unhappy
jhjsjal	unusual
jhkajd	unique
jhkfdfsal	universal
jhkfdfsd	universe
jhkfdfskgh	university
jhkflfj	uniform
jhkg	unit
jhkgd	unite
jhkgdd	united
jhkgh	unity
jhkhlsh	unknown
jhklh	union
jhldss	unless
jhlfdddddhgdd	unprecedented
jhlkkd	unlike
jhlkkdlh	unlikely
jhsdlf	myself
jhsgdfh	mystery
jhsgdfkljs	mysterious
jj-hjj	mm-hmm
jjd	mud
jjdgd	judge
jjdgjdhg	judgment
jjdh	much
jjdkdkal	judicial
jjfddf	murder
jjfh	jury
jjfksdkdgklh	jurisdiction
jjflf	juror
jjggdf	mutter
jjgjal	mutual
jjhgld	jungle
jjhkdklal	municipal
jjhklf	junior
jjjl	jump
jjkdd	juice
jjlgklld	multiple
jjsdjj	museum
jjsdld	muscle
jjsg1	just
jjsg2	must
jjsgkdd	justice
jjsgkfh	justify
jjshfllj	mushroom
jjskd	music
jjskdal	musical
jjskdkah	musician
jjslkj	muslim
jkddld	middle
jkdhkghg	midnight
jkdsg	midst
jkfadld	miracle
jkfflf	mirror
jkgfagklh	migration
jkghg	might
jkhd1	mind
jkhd2	mine
jkhdfal	mineral
jkhjgd	minute
jkhkjal	minimal
jkhkjjj	minimum
jkhkjkad	minimize
jkhksgdf	minister
jkhksgfh	ministry
jkhlf	minor
jkhlfkgh	minority
jkld	mild
jklk	milk
jklkgafh	military
jkll	mill
jkllklh	million
jks	mix
jksdd	mixed
jksgakd	mistake
jksgjfd	mixture
jkss	miss
jksskhg	missing
jksskld	missile
jkssklh	mission
jkssklhafh	missionary
jl	up
jldagd	update
jldd	mode
jlddfagd	moderate
jlddfh	modern
jlddl	model
jlddsg	modest
jldkfh	modify
jlfal	moral
jlfd1	more
jlfd2	move
jlfdjdhg	movement
jlfdlfdf	moreover
jlfgalkgh	mortality
jlfggagd	mortgage
jlfhkhg	morning
jlfkd	movie
jlg	job
jlghdf	mother
jlgkfagd	motivate
jlgkfagklh	motivation
jlgkfd	motive
jlgkjagd	ultimate
jlgkjagdlh	ultimately
jlgkld	mobile
jlgklh	motion
jlglf	motor
jlh	joy
jlhdh	money
jlhgh	month
jlhghlh	monthly
jlhjjdhg	monument
jlhkdh	monkey
jlhkglf	monitor
jlhsgdf	monster
jlj	mom
jljdhg	moment
jljdhgjj	momentum
jljfhal	journal
jljfhalksg	journalist
jljfhalksj	journalism
jljfhdh	journey
jljgh	mouth
jljhg	mount
jljhgakh	mountain
jljsd	mouse
jlkd	joke
jlkh	join
jlkhg	joint
jlld	mood
jllddjld	molecule
jlldf	upper
jllh1	upon
jllh2	moon
jlsdg	upset
jlsg	most
jlsgakfs	upstairs
jlsglh	mostly
js1	us
js2	ms
jsd	use
jsdd	used
jsdf	user
jsdfjl	useful
jsjal	usual
jsjallh	usually
k	i
kd	ie
kdd	ice
kdda	idea
kddal	ideal
kddhgkdal	identical
kddhgkfh	identify
kddhgkfkdagklh	identification
kddhgkgh	identity
kddl	keep
kddlllgh	ideology
kddlllgkdal	ideological
kdh	key
kdlh	icon
kf	if
kfaak	iraqi
kfksh	irish
kflh	iron
kflhh	irony
kflhkdallh	ironically
kg	it
kgalkah	italian
kgdj	item
kghlfd	ignore
kgs	its
kgsdlf	itself
kh	in
khajkfh	inquiry
khdd	knee
khdddd	indeed
khddhgkfd	incentive
khddl	kneel
khddldhddhdd	independence
khddldhddhg	independent
khdds	index
khdfdasd	increase
khdfdasdd	increased
khdfdaskhg	increasing
khdfdaskhglh	increasingly
khdfddkgld	incredible
khdfddkglh	incredibly
khdfkgagld	inevitable
khdfkgaglh	inevitably
khdjsgfh	industry
khdjsgfkal	industrial
khdkah	indian
khdkdagd	indicate
khdkdagklh	indication
khdkdaglf	indicator
khdkddhg	incident
khdkfkdjal	individual
khdkgdhljs	indigenous
khdlfllfagd	incorporate
khdljd	income
khdljdd	include
khdljdkhg	including
khfadd	invade
khfahg	infant
khfasklh	invasion
khfddgklh	infection
khfdhg	invent
khfdhgklh	invention
khfdhglfh	inventory
khfdsg	invest
khfdsgjdhg	investment
khfdsgkgagd	investigate
khfdsgkgagklh	investigation
khfdsgkgaglf	investigator
khfdsglf	investor
khffasgfjdgjfd	infrastructure
khfkgagklh	invitation
khfkgd	invite
khfkskgld	invisible
khflagklh	inflation
khflfj	inform
khflfjagklh	information
khflfjal	informal
khfljdhdd	influence
khfljdhgkal	influential
khfllfd	involve
khfllfdd	involved
khfllfdjdhg	involvement
khgadg	intact
khgdfadg	interact
khgdfadgklh	interaction
khgdfdsg	interest
khgdfdsgdd	interested
khgdfdsgkhg	interesting
khgdffal	interval
khgdffdfd	interfere
khgdffdhgklh	intervention
khgdffjlg	interrupt
khgdffkds	interview
khgdfhagklhal	international
khgdfhal	internal
khgdfhdg	internet
khgdfklf	interior
khgdflfdg	interpret
khgdflfdgagklh	interpretation
khgdgfagd	integrate
khgdgfagdd	integrated
khgdgfagklh	integration
khgdgfkgh	integrity
khgdhd	intend
khgdhg	intent
khgdhgklh	intention
khgdhsd	intense
khgdhskgh	intensity
khgdllddgjal	intellectual
khgdllkgdhdd	intelligence
khgdllkgdhg	intelligent
khgfddkdhg	ingredient
khgfldjdd	introduce
khgfldjdgklh	introduction
khgkjagd	intimate
khgl	into
khhdf	inner
khhdfdhg	inherent
khhdfkg	inherit
khhlddhg	innocent
khhlfagkfd	innovative
khhlfagklh	innovation
khjagd	inmate
khjjfd	injure
khjjfh	injury
khkfd	knife
khkgkagd	initiate
khkgkagkfd	initiative
khkgkal	initial
khkgkallh	initially
khldk	knock
khljg	input
khls	know
khlsh	known
khlslddgd	knowledge
khsddg	insect
khsdfg	insert
khsgahdd	instance
khsgahg	instant
khsgahglh	instantly
khsgall	install
khsgallagklh	installation
khsgdad	instead
khsgfjdg	instruct
khsgfjdgklh	instruction
khsgfjdgklhal	instructional
khsgfjdglf	instructor
khsgfjjdhg	instrument
khsgkgjgklh	institution
khsgkgjgklhal	institutional
khsgkhdg	instinct
khsjfahdd	insurance
khskdd	inside
khskghg	insight
khsksg	insist
khslddgklh	inspection
khslddglf	inspector
khslkfagklh	inspiration
khslkfd	inspire
kjagd	image
kjagkhagklh	imagination
kjagkhd	imagine
kjjddkagd	immediate
kjjddkagdlh	immediately
kjjjhd	immune
kjjkgfagklh	immigration
kjjkgfahg	immigrant
kjladg	impact
kjlfdss	impress
kjlfdsskfd	impressive
kjlfdssklh	impression
kjlflfd	improve
kjlflfdd	improved
kjlflfdjdhg	improvement
kjljlsd	impulse
kjlldjdhg	implement
kjlldjdhgagklh	implementation
kjllfg	import
kjllfgahdd	importance
kjllfgahg	important
kjllfgahglh	importantly
kjllh	imply
kjllkdagklh	implication
kjllsd	impose
kjllsskgld	impossible
kkd	kid
kkdk	kick
kkg	kit
kkgdhdh	kitchen
kkhd	kind
kkhg	king
kkhgdlj	kingdom
kkll	kill
kklldf	killer
kkllkhg	killing
kkss	kiss
klfdah	korean
kll	ill
klldgal	illegal
kllhdss	illness
klljsgfagd	illustrate
klljsklh	illusion
ksfadlk	israeli
kslahd	island
kslaj	islam
kslajkd	islamic
ksllagd	isolate
ksllagdd	isolated
ksllagklh	isolation
kssjd	issue
l'dlldk	o'clock
lad	pad
ladd	pace
ladddf	ladder
ladh	lady
ladk1	lack
ladk2	pack
ladkagd	package
lafadd	parade
lafdhg	parent
lafdhgal	parental
lafg	part
lafgd	large
lafgdlh	largely
lafgh	party
lafghdf	partner
lafghdfshkl	partnership
lafgkal	partial
lafgkallh	partially
lafgkdjlaf	particular
lafgkdjlaflh	particularly
lafgkdklagd	participate
lafgkdklagklh	participation
lafgkdklahg	participant
lafgkdld	particle
lafglh	partly
lafk	park
lafkkhg	parking
lafksh	parish
lag1	lab
lag2	pat
lagd1	late
lagd2	page
lagdf	later
lagdh	patch
lagdhg	patent
lagdl	label
lagdlh	lately
lagflh	patron
lagfll	patrol
laggdf	latter
laggdfh	pattern
lagh	path
lagkdhdd	patience
lagkdhg	patient
lagkh	latin
laglf	labor
laglfaglfh	laboratory
lah1	pay
lah2	lay
lah3	pan
lahd1	land
lahd2	lane
lahdf	layer
lahdjafk	landmark
lahdkhg	landing
lahdl	panel
lahdsdald	landscape
lahg	pant
lahgjagd	language
lahjdhg	payment
lahkd	panic
lajgh	laugh
lajghgdf	laughter
lajhdh	launch
lajl	lamp
lajsd	pause
lak	oak
lakd	lake
lakf	pair
lakh	pain
lakhfjl	painful
lakhg	paint
lakhgdf	painter
lakhgkhg	painting
lal	lap
laladd	palace
lald	pale
laldf	paper
laldsgkhkah	palestinian
lalj	palm
las	law
lasdf	laser
lasg1	last
lasg2	past
lasga	pasta
lasglf	pastor
lash	lawn
lashdf	lawyer
lasjakdf	lawmaker
lass	pass
lassagd	passage
lassdhgdf	passenger
lassjkg	lawsuit
lasskhg	passing
lassklh	passion
ld	pc
ldad	lead
ldadd	peace
ldaddf	leader
ldaddfjl	peaceful
ldaddfshkl	leadership
ldadkhg	leading
ldaf	leaf
ldafd	leave
ldafh	learn
ldafhkhg	learning
ldaghdf	leather
ldagjd	league
ldah	lean
ldahjg	peanut
ldak	peak
ldal	leap
ldasahg	peasant
ldasg	least
ldd	odd
lddah	ocean
lddasklh	occasion
lddasklhal	occasional
lddasklhallh	occasionally
lddf	peer
lddgjfd	lecture
lddjf	occur
lddjlagklh	occupation
lddjlh	occupy
lddl	peel
ldds	odds
ldf	per
ldfddhgagd	percentage
ldfddkfd	perceive
ldfddkfdd	perceived
ldfddlgklh	perception
ldfdl	level
ldffddg	perfect
ldffddglh	perfectly
ldfflfj	perform
ldfflfjahdd	performance
ldfflfjdf	performer
ldfg	left
ldfhals	perhaps
ldfjahdhg	permanent
ldfjkg	permit
ldfjkssklh	permission
ldfkld	period
ldfsjadd	persuade
ldfskah	persian
ldfsksg	persist
ldfslddgkfd	perspective
ldfslh	person
ldfslhal	personal
ldfslhalkgh	personality
ldfslhallh	personally
ldfslhhdl	personnel
ldg1	let
ldg2	leg
ldg3	pet
ldgadh	legacy
ldgal	legal
ldgallh	legally
ldgdhd	legend
ldggdf	letter
ldgkgkjagd	legitimate
ldgkslagjfd	legislature
ldgkslagkfd	legislative
ldgkslagklh	legislation
ldgkslaglf	legislator
ldh	pen
ldhalgh	penalty
ldhd	lend
ldhdkl	pencil
ldhggh	length
ldhs	lens
ldhsklh	pension
ldjlh	lemon
ldlldf	pepper
ldllld	people
ldss	less
ldsslh	lesson
lf1	of
lf2	or
lfadgkdal	practical
lfadgkdallh	practically
lfadgkdd	practice
lfadgkgklhdf	practitioner
lfah	pray
lfahdf	prayer
lfahgd	orange
lfaksd	praise
lfal	oral
lfdadh	preach
lfddaglf	predator
lfddf	order
lfddkdg	predict
lfddkdgklh	prediction
lfddkljs	precious
lfddksd	precise
lfddksdlh	precisely
lfdf	over
lfdfakl	prevail
lfdfall	overall
lfdfdf	prefer
lfdfdfdhdd	preference
lfdfdhg	prevent
lfdfdhgklh	prevention
lfdfdljd	overcome
lfdfhkghg	overnight
lfdfkljs	previous
lfdfkljslh	previously
lfdflllk	overlook
lfdfsdd	oversee
lfdfshdlj	overwhelm
lfdfshdljkhg	overwhelming
lfdgdhd	pretend
lfdggh	pretty
lfdghahdh	pregnancy
lfdghahg	pregnant
lfdh	oven
lfdjkjj	premium
lfdjksd	premise
lfdkhafh	ordinary
lfdlafagklh	preparation
lfdlafd	prepare
lfdlkjkhafh	preliminary
lfdsdffd	preserve
lfdsdfklgklh	prescription
lfdsdhdd	presence
lfdsdhg	present
lfdsdhgagklh	presentation
lfdsjjaglh	presumably
lfdskddhdh	presidency
lfdskddhg	president
lfdskddhgkal	presidential
lfdss	press
lfdssjfd	pressure
lff	off
lffdf	offer
lffdfkhg	offering
lffdhddf	offender
lffdhsd	offense
lffdhskfd	offensive
lffkdd	office
lffkddf	officer
lffkdkal	official
lffkdkallh	officially
lfgah	organ
lfgahkaagklh	organization
lfgahkaagklhal	organizational
lfgahkad	organize
lfgahkadd	organized
lfgahkd	organic
lfgahksj	organism
lfgdh	often
lfgkg	orbit
lfkad	prize
lfkdd1	price
lfkdd2	pride
lfkdhgagklh	orientation
lfkdsg	priest
lfkfadh	privacy
lfkfagd	private
lfkfagdlh	privately
lfkfkldgd	privilege
lfkgkh	origin
lfkgkhal	original
lfkgkhallh	originally
lfkhdklal	principal
lfkhdklld	principle
lfkhg	print
lfkjafh	primary
lfkjafklh	primarily
lfkjd	prime
lfklf	prior
lfklfkgh	priority
lfkslh	prison
lfkslhdf	prisoner
lfl	pro
lfldddd	proceed
lfldddjfd	procedure
lflddss	process
lflddsskhg	processing
lflddsslf	processor
lfldjdd	produce
lfldjddf	producer
lfldjdg	product
lfldjdgkfd	productive
lfldjdgkfkgh	productivity
lfldjdgklh	production
lfldlakj	proclaim
lflfd	prove
lflfdssklh	profession
lflfdssklhal	professional
lflfdsslf	professor
lflfkdd	provide
lflfkddd	provided
lflfkddf	provider
lflfkg	profit
lflfkhdd	province
lflfkld	profile
lflfksklh	provision
lflfljhd	profound
lflflkd	provoke
lflgaglh	probably
lflgddg	protect
lflgddgkfd	protective
lflgddgklh	protection
lflgdkh	protein
lflgdsg	protest
lflgfaj	program
lflgfajjkhg	programming
lflgfdss	progress
lflgfdsskfd	progressive
lflgldj	problem
lflgldll	protocol
lflhkgkg	prohibit
lfljd	proud
lfljddg	project
lfljddgklh	projection
lfljkhdhg	prominent
lfljksd	promise
lfljkskhg	promising
lfljlg	prompt
lfljlgd	promote
lfljlgklh	promotion
lflldf	proper
lflldfgh	property
lflldflh	properly
lfllf	proof
lflllfgklh	proportion
lflllsal	proposal
lflllsd	propose
lflllsdd	proposed
lflsddjgklh	prosecution
lflsddjglf	prosecutor
lflslddg	prospect
lgfkljs	obvious
lgfkljslh	obviously
lggakh	obtain
lghdf	other
lghdfs	others
lghdfsksd	otherwise
lgjddg	object
lgjddgkfd	objective
lgjddgklh	objection
lglkgagklh	obligation
lgsdffagklh	observation
lgsdffd	observe
lgsdffdf	observer
lgsgadld	obstacle
lh1	on
lh2	oh
lhasd	phase
lhd	one
lhd-ghkfd	one-third
lhdd	once
lhdhljdhlh	phenomenon
lhfasd	phrase
lhgl	onto
lhglkhg	ongoing
lhhskdal	physical
lhhskdallh	physically
lhhskdkah	physician
lhhskds	physics
lhklh	onion
lhkllsllhh	philosophy
lhkllsllhkdal	philosophical
lhlgl	photo
lhlglgfalh	photograph
lhlglgfalhdf	photographer
lhlglgfalhh	photography
lhlh	only
lhlhd	phone
lhlkhd	online
lj	pm
ljaald	puzzle
ljdk	luck
ljdkh	lucky
ljf	our
ljfd	pure
ljfdhasd	purchase
ljflld	purple
ljfllsd	purpose
ljfs	ours
ljfsd	purse
ljfsdlfds	ourselves
ljfsjd	pursue
ljfsjkg	pursuit
ljg1	out
ljg2	put
ljgdf	outer
ljgdljd	outcome
ljgdllf	outdoor
ljgfkg	outfit
ljghg	ought
ljgldg	outlet
ljgljg	output
ljglkd	public
ljglkdagklh	publication
ljglkdkgh	publicity
ljglkdlh	publicly
ljglkhd	outline
ljglksh	publish
ljglkshdf	publisher
ljgsgahdkhg	outstanding
ljgskdd	outside
ljgskddf	outsider
ljhdh1	lunch
ljhdh2	punch
ljhg	lung
ljhksh	punish
ljhkshjdhg	punishment
ljjl	pump
ljll	pull
ljlsd	pulse
ljsh	push
lk	ok
lkaaa	pizza
lkagklkgh	liability
lkah	okay
lkahl	piano
lkajkd	liquid
lkd1	lie
lkd2	pie
lkd3	lid
lkddd	piece
lkddhsd	license
lkdgjfd	picture
lkdk	pick
lkdkjl	pickup
lkfd1	life
lkfd2	live
lkfdf	liver
lkfdgkjd	lifetime
lkfdsghld	lifestyle
lkfg	lift
lkfkhg	living
lkg1	pig
lkg2	pit
lkgdfafh	literary
lkgdfagjfd	literature
lkgdfal	liberal
lkgdfallh	literally
lkgdfgh	liberty
lkgdh	pitch
lkgdhdf	pitcher
lkgfafh	library
lkggld	little
lkghg	light
lkghghkhg	lightning
lkghgkhg	lighting
lkghglh	lightly
lkh	pin
lkhd1	line
lkhd2	pine
lkhk1	link
lkhk2	pink
lkjg	limb
lkjkg	limit
lkjkgagklh	limitation
lkjkgdd	limited
lkkd	like
lkkdlh	likely
lkkdlkhlld	likelihood
lkkdsksd	likewise
lkl1	oil
lkl2	lip
lkld1	pipe
lkld2	pile
lklh	lion
lklhddf	pioneer
lkll	pill
lkllg	pilot
lkllls	pillow
lksg	list
lksgdh	listen
lksgdhdf	listener
llad	load
lladd	place
lladdjdhg	placement
llagd	plate
llagflfj	platform
llah1	play
llah2	plan
llah3	loan
llahd	plane
llahdf	player
llahdg	planet
llahg	plant
llahhdf	planner
llahhkhg	planning
llahlff	playoff
llakh	plain
llasgkd	plastic
lld	old
lld-fashklhdd	old-fashioned
llda	plea
lldad	plead
lldagd	locate
lldagklh	location
lldal	local
lldasahg	pleasant
lldasd	please
lldasdd	pleased
lldasjfd	pleasure
lldfa	opera
lldfagd	operate
lldfagkhg	operating
lldfagklh	operation
lldfaglf	operator
lldg	poet
lldgfh	poetry
lldh	open
lldhgh	plenty
lldhkhg	opening
lldhlh	openly
lldj	poem
lldk	lock
lldkdg	pocket
llfd	love
llfdf	lover
llfdfgh	poverty
llfdh	porch
llfdlh	lovely
llfg	port
llfgfah	portray
llfgfakg	portrait
llfgfllkl	portfolio
llfgklh	portion
llfk	pork
llg1	lot
llg2	pot
llg3	log
llg4	opt
llgagl	potato
llgdhgkal	potential
llgdhgkallh	potentially
llggh	lobby
llgkd	logic
llgkdal	logical
llgkjksgkd	optimistic
llgklh	option
llgs	lots
llhal	loyal
llhalgh	loyalty
llhd	pond
llhdlh	lonely
llhg	long
llhg-gdfj	long-term
llhggkjd	longtime
llhjlkd	olympic
llhjlkds	olympics
lljd	loud
lljf	pour
lljhd	pound
lljhgd	plunge
lljs	plus
llkd	poke
llkhg	point
llkhklh	opinion
lll	pop
llld	pole
lllf	poor
lllg	plot
llljlaf	popular
llljlafkgh	popularity
llljlagklh	population
lllk	look
lllkdd	police
lllkddjah	policeman
lllkdh	policy
lllkgkdal	political
lllkgkdallh	politically
lllkgkdkah	politician
lllkgkds	politics
llll1	pool
llll2	poll
llll3	loop
llllfgjhkgh	opportunity
llllhdhg	opponent
lllljgklh	pollution
llllsd	oppose
llllsdd	opposed
llllskgd	opposite
llllskgklh	opposition
lllsd	loose
lls	low
llsd1	lose
llsd2	pose
llsddf	powder
llsdf1	power
llsdf2	lower
llsdffjl	powerful
llsg1	post
llsg2	lost
llsgdf	poster
llskgkfd	positive
llskgklh	position
llss	loss
llssdss	possess
llssdssklh	possession
llsskgklkgh	possibility
llsskgld	possible
llsskglh	possibly
lsd	owe
lsh	own
lshdf	owner
lshdfshkl	ownership
lshdhlllgh	psychology
lshdhlllgkdal	psychological
lshdhlllgksg	psychologist
lshgdh	oxygen
sad	sad
sadfdd	sacred
sadfkfkdd	sacrifice
sadk	sack
saf	war
safd1	save
safd2	safe
safd3	wave
safdgh	safety
safdhljsd	warehouse
safdlh	safely
saffklf	warrior
safh	warn
safhkhg	warning
safj	warm
safjgh	warmth
safkhg	saving
sagd	wage
sagdf	water
sagdh	watch
sagdllkgd	satellite
sagksfadgklh	satisfaction
sagksfh	satisfy
saglh	wagon
sah1	say
sah2	way
sahd	sand
sahddf	wander
sahdgklh	sanction
sahdskdh	sandwich
sahg	want
sajad	squad
sajafd	square
sajd	same
sajdd	sauce
sajddad	squeeze
sajlld	sample
sakd1	wake
sakd2	sake
sakg	wait
sakl	sail
saksg	waist
salad	salad
salafh	salary
sald	sale
salds	sales
salg	salt
saljlh	salmon
salk	walk
salkkhg	walking
sall	wall
sasgd	waste
sash	wash
sd	we
sda	sea
sdaf	wear
sdafd1	scare
sdafd2	weave
sdafdd	scared
sdafdh	search
sdafh	scary
sdag	seat
sdaggdf	scatter
sdaghdf	weather
sdah	scan
sdahdal	scandal
sdajdhdd	sequence
sdak	weak
sdakdh	weaken
sdakhdss	weakness
sdal	seal
sdald	scale
sdalgh	wealth
sdalghh	wealthy
sdallh	weapon
sdaslh	season
sdd	see
sddd1	seed
sddd2	weed
sdddkhg	wedding
sddfdg	secret
sddfdgafh	secretary
sddgklh	section
sddglf	sector
sddhafkl	scenario
sddhd	scene
sddhg	scent
sddj	seem
sddjfd	secure
sddjfkgh	security
sddjkhglh	seemingly
sddjlaf	secular
sddk1	week
sddk2	seek
sddkdhd	weekend
sddklh	weekly
sddlhd	second
sddlhdafh	secondary
sdfagdh	scratch
sdfajgld	scramble
sdfdaj	scream
sdfddh	screen
sdfddhkhg	screening
sdfdfal	several
sdfdfd	severe
sdfdfdlh	severely
sdfdh	seven
sdfdhgh	seventh
sdfds	screw
sdffahg	servant
sdffd	serve
sdffkdd	service
sdffkhg	serving
sdfkds	series
sdfklg	script
sdfkljs	serious
sdfkljslh	seriously
sdg1	set
sdg2	wet
sdg3	web
sdggkhg	setting
sdggld	settle
sdggldjdhg	settlement
sdgjdhg	segment
sdhagd	senate
sdhaglf	senator
sdhd	send
sdhddjld	schedule
sdhdjd	scheme
sdhgdhdd	sentence
sdhgkjdhg	sentiment
sdhklf	senior
sdhllaf	scholar
sdhllafshkl	scholarship
sdhlll	school
sdhsagklh	sensation
sdhsd	sense
sdhskgkfd	sensitive
sdhskgkfkgh	sensitivity
sdjkhaf	seminar
sdjllgjfd	sculpture
sdkad	seize
sdkdhdd	science
sdkdhgkfkd	scientific
sdkdhgksg	scientist
sdkfd	weird
sdkgh	weigh
sdkghg	weight
sdlafagd	separate
sdlafagklh	separation
sdlddg	select
sdlddgdd	selected
sdlddgklh	selection
sdldlj	seldom
sdldljd	welcome
sdlf	self
sdlf-dsgddj	self-esteem
sdlfafd	welfare
sdlfd	score
sdll-gdkhg	well-being
sdll-khlsh	well-known
sdll1	well
sdll2	sell
sdlld	scope
sdlldf	seller
sds	sex
sdsg	west
sdsgdfh	western
sdsh	sexy
sdsjal	sexual
sdsjalkgh	sexuality
sdsjallh	sexually
sdssklh	session
sfal	wrap
sfkgd	write
sfkgdf	writer
sfkggdh	written
sfkgkhg	writing
sfksg	wrist
sflhg	wrong
sgadk	stack
sgadkjj	stadium
sgaf	star
sgafd	stare
sgaff	staff
sgafg	start
sgafgdf	starter
sgafgkhg	starting
sgagd1	state
sgagd2	stage
sgagdjdhg	statement
sgagjd	statue
sgagjgd	statute
sgagjs	status
sgagklh	station
sgagklkgh	stability
sgagksgkdal	statistical
sgagksgkds	statistics
sgagld	stable
sgah	stay
sgahd	stand
sgahdafd	standard
sgahdd	stance
sgahdkhg	standing
sgakd	stake
sgakf	stair
sgdadh	steady
sgdadklh	steadily
sgdaj	steam
sgdak	steak
sgdal	steal
sgddf	steer
sgddl1	steel
sgddl2	steep
sgdj	stem
sgdl	step
sgfagdgh	strategy
sgfagdgkd	strategic
sgfahgd	strange
sgfahgdf	stranger
sgfakghg	straight
sgfakghgdh	straighten
sgfakh	strain
sgfas	straw
sgfdaj	stream
sgfdak	streak
sgfddg	street
sgfdgdh	stretch
sgfdhggh	strength
sgfdhgghdh	strengthen
sgfdss	stress
sgfjdgjfal	structural
sgfjdgjfd	structure
sgfjggld	struggle
sgfkdg	strict
sgfkdglh	strictly
sgfkhg	string
sgfkkd	strike
sgfkkkhg	striking
sgfkl	strip
sgflhg	strong
sgflhglh	strongly
sgflkd	stroke
sghld	style
sgjddhg	student
sgjdh	study
sgjdkl	studio
sgjff	stuff
sgjjgld	stumble
sgjlkd	stupid
sgkdk	stick
sgkf	stir
sgkff	stiff
sgkjjlagd	stimulate
sgkjjljs	stimulus
sgkll	still
sgldk	stock
sglfagd	storage
sglfd1	store
sglfd2	stove
sglfh	story
sglfj	storm
sglhd	stone
sgljadh	stomach
sgll	stop
shadd	shade
shadls	shadow
shafd	share
shafdd	shared
shafdhllddf	shareholder
shafk	shark
shafl	sharp
shafllh	sharply
shag	what
shagdfdf	whatever
shajd	shame
shakd1	shake
shakd2	snake
shal	snap
shald1	shape
shald2	whale
shall	shall
shallls	shallow
shd	she
shdag	wheat
shdak	sneak
shdd	shed
shddf	sheer
shddg	sheet
shddl1	wheel
shddl2	sheep
shddldhakf	wheelchair
shdfd	where
shdfdas	whereas
shdfdfdf	wherever
shdghdf	whether
shdh	when
shdhdfdf	whenever
shdlf	shelf
shdlgdf	shelter
shdll	shell
shfjg	shrug
shfkhk	shrink
shfkjl	shrimp
shh1	why
shh2	shy
shhdfljd	syndrome
shjg	shut
shjggld	shuttle
shjgll	symbol
shjgllkd	symbolic
shjlaghh	sympathy
shjlglj	symptom
shkdh	which
shkfg1	shift
shkfg2	shirt
shkg	shit
shkgd	white
shkhd	shine
shkl1	ship
shkl2	whip
shkld	while
shksldf	whisper
shl	who
shld	shoe
shldfdf	whoever
shldk	shock
shlfd1	shore
shlfd2	shove
shlfg	short
shlfg-gdfj	short-term
shlfgagd	shortage
shlfglh	shortly
shlfgs	shorts
shlg	shot
shlj	whom
shljg	shout
shljld	should
shljlddf	shoulder
shll	shop
shlld	whole
shllg	shoot
shllgkhg	shooting
shlllkhg	shopping
shls1	show
shls2	snow
shlsd	whose
shlsdf	shower
shsgdj	system
sjafg	smart
sjall	small
sjd	sue
sjddddd	succeed
sjdddh	sudden
sjdddhlh	suddenly
sjdddss	success
sjdddssfjl	successful
sjdddssfjllh	successfully
sjdh	such
sjdk	suck
sjdll	smell
sjfd	sure
sjfdlh	surely
sjffadd	surface
sjffdf	suffer
sjffdfkhg	suffering
sjffdh	survey
sjffdkllahdd	surveillance
sjffkdkdhg	sufficient
sjffkfal	survival
sjffkfd	survive
sjffkflf	survivor
sjffljhd	surround
sjffljhdkhg	surrounding
sjfgdfh	surgery
sjfgdlh	surgeon
sjflfksd	surprise
sjflfksdd	surprised
sjflfkskhg	surprising
sjflfkskhglh	surprisingly
sjgaf	sugar
sjggdsg	suggest
sjggdsgklh	suggestion
sjggld	subtle
sjgjddg	subject
sjgjfg	suburb
sjgjfgah	suburban
sjgjkg	submit
sjgsdajdhg	subsequent
sjgsgahdd	substance
sjgsgahgkal	substantial
sjgsgahgkallh	substantially
sjgskdh	subsidy
sjh	sun
sjhhh	sunny
sjhlkghg	sunlight
sjj	sum
sjjjafh	summary
sjjjdf	summer
sjjjkg	summit
sjkdkdd	suicide
sjkg	suit
sjkgagld	suitable
sjkgd	suite
sjkld	smile
sjldf	super
sjldffkslf	supervisor
sjldfjafkdg	supermarket
sjldfklf	superior
sjlfdjd	supreme
sjlkd	smoke
sjllgh	smooth
sjlllfg	support
sjlllfgdf	supporter
sjlllfgkfd	supportive
sjlllh	supply
sjlllkdf	supplier
sjlllsd	suppose
sjlllsdd	supposed
sjlllsddlh	supposedly
sjsgakh	sustain
sjsgakhagld	sustainable
sjslddg	suspect
sjsldhd	suspend
sjslkdklh	suspicion
sjslkdkljs	suspicious
skad	size
skdd1	side
skdd2	wide
skddlh	widely
skddsalk	sidewalk
skddslfdad	widespread
skdk	sick
skdls	widow
skf	sir
skfd1	wife
skfd2	wire
skg	sit
skgd	site
skgh1	with
skgh2	sign
skgh3	sigh
skghagjfd	signature
skghal	signal
skghdfas	withdraw
skghdfasal	withdrawal
skghdss	witness
skghg	sight
skghkfkdahdd	significance
skghkfkdahg	significant
skghkfkdahglh	significantly
skghkh	within
skghljg	without
skgjagklh	situation
skglkhg	sibling
skh1	win
skh2	sky
skh3	sin
skhd1	wind
skhd2	wine
skhdd	since
skhdls	window
skhg1	sing
skhg2	wing
skhgdf1	winter
skhgdf2	singer
skhgld	single
skhhdf	winner
skhk	sink
skjjlgahdljslh	simultaneously
skjklaf	similar
skjklafkgh	similarity
skjklaflh	similarly
skjll	skull
skjlld	simple
skjllh	simply
skk	ski
skkfg	skirt
skkh	skin
skkl	skip
skkll	skill
skklldd	skilled
skld1	wild
skld2	wipe
sklddfhdss	wilderness
skldhdd	silence
skldhg	silent
skldlkfd	wildlife
sklfdf	silver
sklk	silk
skll	will
skllh	silly
skllkhg	willing
skllkhghdss	willingness
sks	six
sksd	wise
sksdlj	wisdom
sksgdf	sister
sksgh	sixth
sksh	wish
sl	so
sl-dalldd	so-called
sladd	space
slaf	soar
slafd1	slave
slafd2	spare
slafdfh	slavery
slafk	spark
slahksh	spanish
slaj	slam
slak	soak
slal1	slap
slal2	soap
sldak	speak
sldakdf	speaker
slddd	speed
sldddf	soccer
sldddh	speech
slddfd	sleeve
slddgadjlaf	spectacular
slddgfjj	spectrum
slddjlagd	speculate
slddjlagklh	speculation
slddkal	special
slddkalgh	specialty
slddkalkad	specialize
slddkalksg	specialist
slddkds	species
slddkfh	specify
slddkfkd	specific
slddkfkdallh	specifically
slddl	sleep
sldhd	spend
sldhdkhg	spending
sldk	sock
sldkal	social
sldkallh	socially
sldkdgh	society
sldkjj	sodium
sldll	spell
slfa	sofa
slfah	spray
slfd	word
slfdad	spread
slfdfdkghgh	sovereignty
slffh1	worry
slffh2	sorry
slffkdd	worried
slfg1	sort
slfg2	soft
slfgdh	soften
slfgh	worth
slfglh	softly
slfgsafd	software
slfk	work
slfkdf	worker
slfkdg	soviet
slfkhg	spring
slfkhkld	sprinkle
slfkkhg	working
slfkljg	workout
slfklladd	workplace
slfks	works
slfkshll	workshop
slfld	world
slfldskdd	worldwide
slh1	son
slh2	spy
slhddf	wonder
slhddffjl	wonderful
slhdfd	sphere
slhg	song
sljah	woman
sljd	some
sljddah	someday
sljdghkhg	something
sljdgkjd	sometime
sljdgkjds	sometimes
sljdgldh	somebody
sljdhls	somehow
sljdlhd	someone
sljdshag	somewhat
sljdshdfd	somewhere
sljfdd	source
sljgh	south
sljghdasg	southeast
sljghdfh	southern
sljghsdsg	southwest
sljhd1	sound
sljhd2	wound
sljl1	soul
sljl2	soup
sljld	would
slkdd1	slide
slkdd2	slice
slkfkg	spirit
slkfkgjal	spiritual
slkg	spit
slkgd	spite
slkghg	slight
slkghglh	slightly
slkh	spin
slkhd	spine
slkl1	slip
slkl2	soil
slkll	spill
sllaf	solar
slld1	wood
slld2	sole
sllddh	wooden
slldkdf	soldier
slldlh	solely
sllf	wolf
sllfd	solve
sllfg	sport
sllg1	spot
sllg2	slot
sllh	soon
sllhksgkdagdd	sophisticated
sllhslf	sponsor
slljgklh	solution
slljsd	spouse
sllkd	solid
sllkdsjah	spokesman
sllkg	split
sllld	slope
slllh	spoon
slls	slow
sllslh	slowly
sls	wow
ssallls	swallow
ssdaf	swear
ssdag	sweat
ssdagdf	sweater
ssddg	sweet
ssddl	sweep
ssdll	swell
sskgdh	switch
sskhg	swing
sskj	swim
sskjjkhg	swimming
sslfd	sword
