the	ghd
be	gd
and	ahd
of	lf
a	a
in	kh
to	gl
have	hafd
it	kg
i	k
that	ghag
for	flf
you	hlj
he	hd
with	skgh
on	lh
do	dl
say	sah
this	ghks
they	ghdh
at	ag
but	gjg
we	sd
his	hks
from	fflj
not	hlg
by	gh
she	shd
or	lf
as	as
what	shag
go	gl
their	ghdkf
can	dah
who	shl
get	gdg
if	kf
would	sljld
her	hdf
all	all
my	jh
make	jakd
about	agljg
know	khls
will	skll
up	jl
one	lhd
time	gkjd
there	ghdfd
year	hdaf
so	sl
think	ghkhk
when	shdh
which	shkdh
them	ghdj
some	sljd
me	jd
people	ldllld
take	gakd
out	ljg
into	khgl
just	jjsg
see	sdd
him	hkj
your	hljf
come	dljd
could	dljld
now	hls
than	ghah
like	lkkd
other	lghdf
how	hls
then	ghdh
its	kgs
our	ljf
two	gsl
more	jlfd
these	ghdsd
want	sahg
way	sah
look	lllk
first	fkfsg
also	alsl
new	hds
because	gddajsd
day	dah
use	jsd
no	hl
man	jah
find	fkhd
here	hdfd
thing	ghkhg
give	gkfd
many	jahh
well	sdll
only	lhlh
those	ghlsd
tell	gdll
very	fdfh
even	dfdh
back	gadk
any	ahh
good	glld
woman	sljah
through	ghfljgh
us	js
life	lkfd
child	dhkld
work	slfk
down	dlsh
may	jah
after	afgdf
should	shljld
call	dall
world	slfld
over	lfdf
school	sdhlll
still	sgkll
try	gfh
last	lasg
ask	ask
need	hddd
too	gll
feel	fddl
three	ghfdd
state	sgagd
never	hdfdf
become	gddljd
between	gdgsddh
high	hkgh
really	fdallh
something	sljdghkhg
most	jlsg
another	ahlghdf
much	jjdh
family	fajklh
own	lsh
leave	ldafd
put	ljg
old	lld
while	shkld
mean	jdah
keep	kddl
student	sgjddhg
why	shh
let	ldg
great	gfdag
same	sajd
big	gkg
group	gfljl
begin	gdgkh
seem	sddj
country	dljhgfh
help	hdll
talk	galk
where	shdfd
turn	gjfh
problem	lflgldj
every	dfdfh
start	sgafg
hand	hahd
might	jkghg
american	ajdfkdah
show	shls
part	lafg
against	agakhsg
place	lladd
such	sjdh
again	agakh
few	fds
case	dasd
week	sddk
company	dljlahh
system	shsgdj
each	dadh
right	fkghg
program	lflgfaj
hear	hdaf
question	ajdsgklh
during	djfkhg
play	llah
government	glfdfhjdhg
run	fjh
small	sjall
number	hjjgdf
off	lff
always	alsahs
move	jlfd
night	hkghg
live	lkfd
mr	jf
point	llkhg
believe	gdlkdfd
hold	hlld
today	gldah
bring	gfkhg
happen	halldh
next	hdsg
without	skghljg
before	gdflfd
large	lafgd
million	jkllklh
must	jjsg
home	hljd
under	jhddf
water	sagdf
room	fllj
write	sfkgd
mother	jlghdf
area	afda
national	hagklhal
money	jlhdh
story	sglfh
young	hljhg
fact	fadg
month	jlhgh
different	dkffdfdhg
lot	llg
study	sgjdh
book	gllk
eye	dhd
job	jlg
word	slfd
though	ghljgh
business	gjskhdss
issue	kssjd
side	skdd
kind	kkhd
four	fljf
head	hdad
far	faf
black	gladk
long	llhg
both	glgh
little	lkggld
house	hljsd
yes	hds
since	skhdd
provide	lflfkdd
service	sdffkdd
around	afljhd
friend	ffkdhd
important	kjllfgahg
father	faghdf
sit	skg
away	asah
until	jhgkl
power	llsdf
hour	hljf
game	gajd
often	lfgdh
yet	hdg
line	lkhd
political	lllkgkdal
end	dhd
among	ajlhg
ever	dfdf
stand	sgahd
bad	gad
lose	llsd
however	hlsdfdf
member	jdjgdf
pay	lah
law	las
meet	jddg
car	daf
city	dkgh
almost	aljlsg
include	khdljdd
continue	dlhgkhjd
set	sdg
later	lagdf
community	dljjjhkgh
name	hajd
five	fkfd
once	lhdd
white	shkgd
least	ldasg
president	lfdskddhg
learn	ldafh
real	fdal
change	dhahgd
team	gdaj
minute	jkhjgd
best	gdsg
several	sdfdfal
idea	kdda
kid	kkd
body	gldh
information	khflfjagklh
nothing	hlghkhg
ago	agl
lead	ldad
social	sldkal
understand	jhddfsgahd
whether	shdghdf
watch	sagdh
together	glgdghdf
follow	flllls
parent	lafdhg
stop	sgll
face	fadd
anything	ahhghkhg
create	dfdagd
public	ljglkd
already	alfdadh
speak	sldak
others	lghdfs
read	fdad
level	ldfdl
allow	allls
add	add
office	lffkdd
spend	sldhd
door	dllf
health	hdalgh
person	ldfslh
art	afg
sure	sjfd
war	saf
history	hksglfh
party	lafgh
within	skghkh
grow	gfls
result	fdsjlg
open	lldh
morning	jlfhkhg
walk	salk
reason	fdaslh
low	lls
win	skh
research	fdsdafdh
girl	gkfl
guy	gjh
early	daflh
food	flld
moment	jljdhg
himself	hkjsdlf
air	akf
teacher	gdadhdf
force	flfdd
offer	lffdf
enough	dhljgh
education	ddjdagklh
across	adflss
although	alghljgh
remember	fdjdjgdf
foot	fllg
second	sddlhd
boy	glh
maybe	jahgd
toward	glsafd
able	agld
age	agd
policy	lllkdh
everything	dfdfhghkhg
love	llfd
process	lflddss
music	jjskd
including	khdljdkhg
consider	dlhskddf
appear	alldaf
actually	adgjallh
buy	gjh
probably	lflgaglh
human	hjjah
wait	sakg
serve	sdffd
market	jafkdg
die	dkd
send	sdhd
expect	dslddg
sense	sdhsd
build	gjkld
stay	sgah
fall	fall
oh	lh
nation	hagklh
plan	llah
cut	djg
college	dllldgd
interest	khgdfdsg
death	ddagh
course	dljfsd
someone	sljdlhd
experience	dsldfkdhdd
behind	gdhkhd
reach	fdadh
local	lldal
kill	kkll
six	sks
remain	fdjakh
effect	dffddg
yeah	hdah
suggest	sjggdsg
class	dlass
control	dlhgfll
raise	faksd
care	dafd
perhaps	ldfhals
late	lagd
hard	hafd
field	fkdld
else	dlsd
pass	lass
former	flfjdf
sell	sdll
major	jajlf
sometimes	sljdgkjds
require	fdajkfd
along	allhg
development	ddfdllljdhg
themselves	ghdjsdlfds
report	fdllfg
role	flld
better	gdggdf
economic	ddlhljkd
effort	dfflfg
decide	dddkdd
rate	fagd
strong	sgflhg
possible	llsskgld
heart	hdafg
drug	dfjg
leader	ldaddf
light	lkghg
voice	flkdd
wife	skfd
whole	shlld
police	lllkdd
mind	jkhd
finally	fkhallh
pull	ljll
return	fdgjfh
free	ffdd
military	jklkgafh
price	lfkdd
less	ldss
according	addlfdkhg
decision	dddksklh
explain	dsllakh
son	slh
hope	hlld
develop	ddfdlll
view	fkds
relationship	fdlagklhshkl
carry	daffh
town	glsh
road	flad
drive	dfkfd
arm	afj
true	gfjd
federal	fdddfal
break	gfdak
difference	dkffdfdhdd
thank	ghahk
receive	fdddkfd
value	faljd
international	khgdfhagklhal
building	gjkldkhg
action	adgklh
full	fjll
model	jlddl
join	jlkh
season	sdaslh
society	sldkdgh
tax	gas
director	dkfddglf
position	llskgklh
player	llahdf
agree	agfdd
especially	dslddkallh
record	fddlfd
pick	lkdk
wear	sdaf
paper	laldf
special	slddkal
space	sladd
ground	gfljhd
form	flfj
support	sjlllfg
event	dfdhg
official	lffkdkal
whose	shlsd
matter	jaggdf
everyone	dfdfhlhd
center	ddhgdf
couple	dljlld
site	skgd
project	lfljddg
hit	hkg
base	gasd
activity	adgkfkgh
star	sgaf
table	gagld
court	dljfg
produce	lfldjdd
eat	dag
teach	gdadh
oil	lkl
half	half
situation	skgjagklh
easy	dash
cost	dlsg
industry	khdjsgfh
figure	fkgjfd
street	sgfddg
image	kjagd
itself	kgsdlf
phone	lhlhd
either	dkghdf
data	daga
cover	dlfdf
quite	ajkgd
picture	lkdgjfd
clear	dldaf
practice	lfadgkdd
piece	lkddd
land	lahd
recent	fdddhg
describe	ddsdfkgd
product	lfldjdg
doctor	dldglf
wall	sall
patient	lagkdhg
worker	slfkdf
news	hdss
test	gdsg
movie	jlfkd
certain	ddfgakh
north	hlfgh
personal	ldfslhal
simply	skjllh
third	ghkfd
technology	gddhhlllgh
catch	dagdh
step	sgdl
baby	gagh
computer	dljljgdf
type	ghld
attention	aggdhgklh
draw	dfas
film	fklj
republican	fdljglkdah
tree	gfdd
source	sljfdd
red	fdd
nearly	hdaflh
organization	lfgahkaagklh
choose	dhllsd
cause	dajsd
hair	hakf
century	ddhgjfh
evidence	dfkddhdd
window	skhdls
difficult	dkffkdjlg
listen	lksgdh
soon	sllh
culture	djlgjfd
billion	gkllklh
chance	dhahdd
brother	gflghdf
energy	dhdfgh
period	ldfkld
summer	sjjjdf
realize	fdalkad
hundred	hjhdfdd
available	afaklagld
plant	llahg
likely	lkkdlh
opportunity	llllfgjhkgh
term	gdfj
short	shlfg
letter	ldggdf
condition	dlhdkgklh
choice	dhlkdd
single	skhgld
rule	fjld
daughter	dajghgdf
administration	adjkhksgfagklh
south	sljgh
husband	hjsgahd
congress	dlhgfdss
floor	flllf
campaign	dajlakgh
material	jagdfkal
population	llljlagklh
economy	ddlhljh
medical	jddkdal
hospital	hlslkgal
church	dhjfdh
close	dllsd
thousand	ghljsahd
risk	fksk
current	djffdhg
fire	fkfd
future	fjgjfd
wrong	sflhg
involve	khfllfd
defense	ddfdhsd
anyone	ahhlhd
increase	khdfdasd
security	sddjfkgh
bank	gahk
myself	jhsdlf
certainly	ddfgakhlh
west	sdsg
sport	sllfg
board	glafd
seek	sddk
per	ldf
subject	sjgjddg
officer	lffkddf
private	lfkfagd
rest	fdsg
behavior	gdhafklf
deal	ddal
performance	ldfflfjahdd
fight	fkghg
throw	ghfls
top	gll
quickly	ajkdklh
past	lasg
goal	glal
bed	gdd
order	lfddf
author	ajghlf
fill	fkll
represent	fdlfdsdhg
focus	fldjs
foreign	flfdkgh
drop	dfll
blood	gllld
upon	jllh
agency	agdhdh
push	ljsh
nature	hagjfd
color	dlllf
recently	fdddhglh
store	sglfd
reduce	fddjdd
sound	sljhd
note	hlgd
fine	fkhd
near	hdaf
movement	jlfdjdhg
page	lagd
enter	dhgdf
share	shafd
common	dljjlh
poor	lllf
natural	hagjfal
race	fadd
concern	dlhddfh
series	sdfkds
significant	skghkfkdahg
similar	skjklaf
hot	hlg
language	lahgjagd
usually	jsjallh
response	fdsllhsd
dead	ddad
rise	fksd
animal	ahkjal
factor	fadglf
decade	dddadd
article	afgkdld
shoot	shllg
east	dasg
save	safd
seven	sdfdh
artist	afgksg
scene	sddhd
stock	sgldk
career	dafddf
despite	ddslkgd
central	ddhgfal
eight	dkghg
thus	ghjs
treatment	gfdagjdhg
beyond	gdhlhd
happy	hallh
exactly	dsadglh
protect	lflgddg
approach	allfladh
lie	lkd
size	skad
dog	dlg
fund	fjhd
serious	sdfkljs
occur	lddjf
media	jddka
ready	fdadh
sign	skgh
thought	ghljghg
list	lksg
individual	khdkfkdjal
simple	skjlld
quality	ajalkgh
pressure	lfdssjfd
accept	adddlg
answer	ahssdf
resource	fdsljfdd
identify	kddhgkfh
left	ldfg
meeting	jddgkhg
determine	ddgdfjkhd
prepare	lfdlafd
disease	dksdasd
whatever	shagdfdf
success	sjdddss
argue	afgjd
cup	djl
particularly	lafgkdjlaflh
amount	ajljhg
ability	agklkgh
staff	sgaff
recognize	fddlghkad
indicate	khdkdagd
character	dhafadgdf
growth	gflsgh
loss	llss
degree	ddgfdd
wonder	slhddf
attack	aggadk
herself	hdfsdlf
region	fdgklh
television	gdldfksklh
box	gls
tv	gf
training	gfakhkhg
pretty	lfdggh
trade	gfadd
election	dlddgklh
everybody	dfdfhgldh
physical	lhhskdal
lay	lah
general	gdhdfal
feeling	fddlkhg
standard	sgahdafd
bill	gkll
message	jdssagd
fail	fakl
outside	ljgskdd
arrive	affkfd
analysis	ahalhsks
benefit	gdhdfkg
sex	sds
forward	flfsafd
lawyer	lashdf
present	lfdsdhg
section	sddgklh
environmental	dhfkflhjdhgal
glass	glass
skill	skkll
sister	sksgdf
pm	lj
professor	lflfdsslf
operation	lldfagklh
financial	fkhahdkal
crime	dfkjd
stage	sgagd
ok	lk
compare	dljlafd
authority	ajghlfkgh
miss	jkss
design	ddskgh
sort	slfg
act	adg
ten	gdh
knowledge	khlslddgd
gun	gjh
station	sgagklh
blue	gljd
strategy	sgfagdgh
clearly	dldaflh
discuss	dksdjss
indeed	khdddd
truth	gfjgh
song	slhg
example	dsajlld
democratic	ddjldfagkd
check	dhddk
environment	dhfkflhjdhg
leg	ldg
dark	dafk
various	fafkljs
rather	faghdf
laugh	lajgh
guess	gjdss
executive	dsddjgkfd
prove	lflfd
hang	hahg
entire	dhgkfd
rock	fldk
forget	flfgdg
claim	dlakj
remove	fdjlfd
manager	jahagdf
enjoy	dhjlh
network	hdgslfk
legal	ldgal
religious	fdlkgkljs
cold	dlld
final	fkhal
main	jakh
science	sdkdhdd
green	gfddh
memory	jdjlfh
card	dafd
above	aglfd
seat	sdag
cell	ddll
establish	dsgaglksh
nice	hkdd
trial	gfkal
expert	dsldfg
spring	slfkhg
firm	fkfj
democrat	ddjldfag
radio	fadkl
visit	fkskg
management	jahagdjdhg
avoid	aflkd
imagine	kjagkhd
tonight	glhkghg
huge	hjgd
ball	gall
finish	fkhksh
yourself	hljfsdlf
theory	ghdlfh
impact	kjladg
respond	fdsllhd
statement	sgagdjdhg
maintain	jakhgakh
charge	dhafgd
popular	llljlaf
traditional	gfadkgklhal
onto	lhgl
reveal	fdfdal
direction	dkfddgklh
weapon	sdallh
employee	djlllhdd
cultural	djlgjfal
contain	dlhgakh
peace	ldadd
pain	lakh
apply	alllh
measure	jdasjfd
wide	skdd
shake	shakd
fly	flh
interview	khgdffkds
manage	jahagd
chair	dhakf
fish	fksh
particular	lafgkdjlaf
camera	dajdfa
structure	sgfjdgjfd
politics	lllkgkds
perform	ldfflfj
bit	gkg
weight	sdkghg
suddenly	sjdddhlh
discover	dksdlfdf
candidate	dahdkdagd
production	lfldjdgklh
treat	gfdag
trip	gfkl
evening	dfdhkhg
affect	affddg
inside	khskdd
conference	dlhfdfdhdd
unit	jhkg
style	sghld
adult	adjlg
worry	slffh
range	fahgd
mention	jdhgklh
deep	dddl
edge	ddgd
specific	slddkfkd
writer	sfkgdf
trouble	gfljgld
necessary	hdddssafh
throughout	ghfljghljg
challenge	dhalldhgd
fear	fdaf
shoulder	shljlddf
institution	khsgkgjgklh
middle	jkddld
sea	sda
dream	dfdaj
bar	gaf
beautiful	gdajgkfjl
property	lflldfgh
instead	khsgdad
improve	kjlflfd
stuff	sgjff
detail	ddgakl
method	jdghld
somebody	sljdgldh
magazine	jagaakhd
hotel	hlgdl
soldier	slldkdf
reflect	fdflddg
heavy	hdafh
sexual	sdsjal
bag	gag
heat	hdag
marriage	jaffkagd
tough	gljgh
sing	skhg
surface	sjffadd
purpose	ljfllsd
exist	dsksg
pattern	laggdfh
whom	shlj
skin	skkh
agent	agdhg
owner	lshdf
machine	jadhkhd
gas	gas
ahead	ahdad
generation	gdhdfagklh
commercial	dljjdfdkal
address	addfdss
cancer	dahddf
item	kgdj
reality	fdalkgh
coach	dladh
mrs	jfs
yard	hafd
beat	gdag
violence	fklldhdd
total	glgal
tend	gdhd
investment	khfdsgjdhg
discussion	dksdjssklh
finger	fkhgdf
garden	gafddh
notice	hlgkdd
collection	dlllddgklh
modern	jlddfh
task	gask
partner	lafghdf
positive	llskgkfd
civil	dkfkl
kitchen	kkgdhdh
consumer	dlhsjjdf
shot	shlg
budget	gjdgdg
wish	sksh
painting	lakhgkhg
scientist	sdkdhgksg
safe	safd
agreement	agfddjdhg
capital	dalkgal
mouth	jljgh
nor	hlf
victim	fkdgkj
newspaper	hdsslaldf
threat	ghfdag
responsibility	fdsllhskgklkgh
smile	sjkld
attorney	agglfhdh
score	sdlfd
account	addljhg
interesting	khgdfdsgkhg
audience	ajdkdhdd
rich	fkdh
dinner	dkhhdf
vote	flgd
western	sdsgdfh
relate	fdlagd
travel	gfafdl
debate	ddgagd
prevent	lfdfdhg
citizen	dkgkadh
majority	jajlfkgh
none	hlhd
front	fflhg
born	glfh
admit	adjkg
senior	sdhklf
assume	assjjd
wind	skhd
key	kdh
professional	lflfdssklhal
mission	jkssklh
fast	fasg
alone	allhd
customer	djsgljdf
suffer	sjffdf
speech	sldddh
successful	sjdddssfjl
option	llgklh
participant	lafgkdklahg
southern	sljghdfh
fresh	ffdsh
eventually	dfdhgjallh
forest	flfdsg
video	fkddl
global	gllgal
senate	sdhagd
reform	fdflfj
access	adddss
restaurant	fdsgajfahg
judge	jjdgd
publish	ljglksh
relation	fdlagklh
release	fdldasd
bird	gkfd
opinion	llkhklh
credit	dfddkg
critical	dfkgkdal
corner	dlfhdf
concerned	dlhddfhdd
recall	fddall
version	fdfsklh
stare	sgafd
safety	safdgh
effective	dffddgkfd
neighborhood	hdkghglfhlld
original	lfkgkhal
troop	gflll
income	khdljd
directly	dkfddglh
hurt	hjfg
species	slddkds
immediately	kjjddkagdlh
track	gfadk
basic	gaskd
strike	sgfkkd
sky	skh
freedom	ffdddlj
absolutely	agslljgdlh
plane	llahd
nobody	hlgldh
achieve	adhkdfd
object	lgjddg
attitude	aggkgjdd
labor	laglf
refer	fdfdf
concept	dlhddlg
client	dlkdhg
powerful	llsdffjl
perfect	ldffddg
nine	hkhd
therefore	ghdfdflfd
conduct	dlhdjdg
announce	ahhljhdd
conversation	dlhfdfsagklh
examine	dsajkhd
touch	gljdh
please	lldasd
attend	aggdhd
completely	dljlldgdlh
variety	fafkdgh
sleep	slddl
involved	khfllfdd
investigation	khfdsgkgagklh
nuclear	hjdldaf
researcher	fdsdafdhdf
press	lfdss
conflict	dlhflkdg
spirit	slkfkg
replace	fdlladd
british	gfkgksh
encourage	dhdljfagd
argument	afgjjdhg
camp	dajl
brain	gfakh
feature	fdagjfd
afternoon	afgdfhllh
am	aj
weekend	sddkdhd
dozen	dladh
possibility	llsskgklkgh
insurance	khsjfahdd
department	ddlafgjdhg
battle	gaggld
beginning	gdgkhhkhg
date	dagd
generally	gdhdfallh
african	affkdah
sorry	slffh
crisis	dfksks
complete	dljlldgd
fan	fah
stick	sgkdk
define	ddfkhd
easily	dasklh
hole	hlld
element	dldjdhg
vision	fksklh
status	sgagjs
normal	hlfjal
chinese	dhkhdsd
ship	shkl
solution	slljgklh
stone	sglhd
slowly	sllslh
scale	sdald
university	jhkfdfskgh
introduce	khgfldjdd
driver	dfkfdf
attempt	aggdjlg
park	lafk
spot	sllg
lack	ladk
ice	kdd
boat	glag
drink	dfkhk
sun	sjh
distance	dksgahdd
wood	slld
handle	hahdld
truck	gfjdk
mountain	jljhgakh
survey	sjffdh
supposed	sjlllsdd
tradition	gfadkgklh
winter	skhgdf
village	fkllagd
soviet	slfkdg
refuse	fdfjsd
sales	salds
roll	flll
communication	dljjjhkdagklh
screen	sdfddh
gain	gakh
resident	fdskddhg
hide	hkdd
gold	glld
club	dljg
farm	fafj
potential	llgdhgkal
european	djflldah
presence	lfdsdhdd
independent	khddldhddhg
district	dksgfkdg
shape	shald
reader	fdaddf
ms	js
contract	dlhgfadg
crowd	dflsd
christian	dhfksgkah
express	dslfdss
apartment	alafgjdhg
willing	skllkhg
strength	sgfdhggh
previous	lfdfkljs
band	gahd
obviously	lgfkljslh
horse	hlfsd
interested	khgdfdsgdd
target	gafgdg
prison	lfkslh
ride	fkdd
guard	gjafd
terms	gdfjs
demand	ddjahd
reporter	fdllfgdf
deliver	ddlkfdf
text	gdsg
tool	glll
wild	skld
vehicle	fdhkdld
observe	lgsdffd
flight	flkghg
facility	fadklkgh
understanding	jhddfsgahdkhg
average	afdfagd
emerge	djdfgd
advantage	adfahgagd
quick	ajkdk
leadership	ldaddfshkl
earn	dafh
pound	lljhd
basis	gasks
bright	gfkghg
operate	lldfagd
guest	gjdsg
sample	sajlld
contribute	dlhgfkgjgd
tiny	gkhh
block	glldk
protection	lflgddgklh
settle	sdggld
feed	fddd
collect	dlllddg
additional	addkgklhal
highly	hkghlh
identity	kddhgkgh
title	gkgld
mostly	jlsglh
lesson	ldsslh
faith	fakgh
river	fkfdf
promote	lfljlgd
living	lkfkhg
count	dljhg
unless	jhldss
marry	jaffh
tomorrow	gljlffls
technique	gddhhkajd
path	lagh
ear	daf
shop	shll
folk	fllk
principle	lfkhdklld
survive	sjffkfd
lift	lkfg
border	glfddf
competition	dljldgkgklh
jump	jjjl
gather	gaghdf
limit	lkjkg
fit	fkg
cry	dfh
equipment	dajkljdhg
worth	slfgh
associate	assldkagd
critic	dfkgkd
warm	safj
aspect	aslddg
insist	khsksg
failure	fakljfd
annual	ahhjal
french	ffdhdh
christmas	dhfksgjas
comment	dljjdhg
responsible	fdsllhskgld
affair	affakf
procedure	lfldddjfd
regular	fdgjlaf
spread	slfdad
chairman	dhakfjah
baseball	gasdgall
soft	slfg
ignore	kghlfd
egg	dgg
belief	gdlkdf
demonstrate	ddjlhsgfagd
anybody	ahhgldh
murder	jjfddf
gift	gkfg
religion	fdlkgklh
review	fdfkds
editor	ddkglf
engage	dhgagd
coffee	dlffdd
document	dldjjdhg
speed	slddd
cross	dflss
influence	khfljdhdd
anyway	ahhsah
threaten	ghfdagdh
commit	dljjkg
female	fdjald
youth	hljgh
wave	safd
afraid	affakd
quarter	ajafgdf
background	gadkgfljhd
native	hagkfd
broad	gflad
wonderful	slhddffjl
deny	ddhh
apparently	allafdhglh
slightly	slkghglh
reaction	fdadgklh
twice	gskdd
suit	sjkg
perspective	ldfslddgkfd
growing	gflskhg
blow	glls
construction	dlhsgfjdgklh
intelligence	khgdllkgdhdd
destroy	ddsgflh
cook	dllk
connection	dlhhddgklh
burn	gjfh
shoe	shld
grade	gfadd
context	dlhgdsg
committee	dljjkggdd
hey	hdh
mistake	jksgakd
location	lldagklh
clothes	dllghds
indian	khdkah
quiet	ajkdg
dress	dfdss
promise	lfljksd
aware	asafd
neighbor	hdkghglf
function	fjhdgklh
bone	glhd
active	adgkfd
extend	dsgdhd
chief	dhkdf
combine	dljgkhd
wine	skhd
below	gdlls
cool	dlll
voter	flgdf
learning	ldafhkhg
bus	gjs
hell	hdll
dangerous	dahgdfljs
remind	fdjkhd
moral	jlfal
united	jhkgdd
category	dagdglfh
relatively	fdlagkfdlh
victory	fkdglfh
academic	adaddjkd
internet	khgdfhdg
healthy	hdalghh
negative	hdgagkfd
following	fllllskhg
historical	hksglfkdal
medicine	jddkdkhd
tour	gljf
depend	ddldhd
photo	lhlgl
finding	fkhdkhg
grab	gfag
direct	dkfddg
classroom	dlassfllj
contact	dlhgadg
justice	jjsgkdd
participate	lafgkdklagd
daily	daklh
fair	fakf
pair	lakf
famous	fajljs
exercise	dsdfdksd
knee	khdd
flower	fllsdf
tape	gald
hire	hkfd
familiar	fajklkaf
appropriate	allfllfkagd
supply	sjlllh
fully	fjllh
actor	adglf
birth	gkfgh
search	sdafdh
tie	gkd
democracy	ddjldfadh
eastern	dasgdfh
primary	lfkjafh
yesterday	hdsgdfdah
circle	dkfdld
device	ddfkdd
progress	lflgfdss
bottom	glgglj
island	kslahd
exchange	dsdhahgd
clean	dldah
studio	sgjdkl
train	gfakh
lady	ladh
colleague	dllldagjd
application	alllkdagklh
neck	hddk
lean	ldah
damage	dajagd
plastic	llasgkd
tall	gall
plate	llagd
hate	hagd
otherwise	lghdfsksd
writing	sfkgkhg
male	jald
alive	alkfd
expression	dslfdssklh
football	fllggall
intend	khgdhd
chicken	dhkdkdh
army	afjh
abuse	agjsd
theater	ghdagdf
shut	shjg
map	jal
extra	dsgfa
session	sdssklh
danger	dahgdf
welcome	sdldljd
domestic	dljdsgkd
lots	llgs
literature	lkgdfagjfd
rain	fakh
desire	ddskfd
assessment	assdssjdhg
injury	khjjfh
respect	fdslddg
northern	hlfghdfh
nod	hld
paint	lakhg
fuel	fjdl
leaf	ldaf
dry	dfh
russian	fjsskah
instruction	khsgfjdgklh
pool	llll
climb	dlkjg
sweet	ssddg
engine	dhgkhd
fourth	fljfgh
salt	salg
expand	dslahd
importance	kjllfgahdd
metal	jdgal
fat	fag
ticket	gkdkdg
software	slfgsafd
disappear	dksalldaf
corporate	dlfllfagd
strange	sgfahgd
lip	lkl
reading	fdadkhg
urban	jfgah
mental	jdhgal
increasingly	khdfdaskhglh
lunch	ljhdh
educational	ddjdagklhal
somewhere	sljdshdfd
farmer	fafjdf
sugar	sjgaf
planet	llahdg
favorite	faflfkgd
explore	dslllfd
obtain	lggakh
enemy	dhdjh
greatest	gfdagdsg
complex	dljllds
surround	sjffljhd
athlete	aghldgd
invite	khfkgd
repeat	fdldag
carefully	dafdfjllh
soul	sljl
scientific	sdkdhgkfkd
impossible	kjllsskgld
panel	lahdl
meaning	jdahkhg
mom	jlj
married	jaffkdd
instrument	khsgfjjdhg
predict	lfddkdg
weather	sdaghdf
presidential	lfdskddhgkal
emotional	djlgklhal
commitment	dljjkgjdhg
supreme	sjlfdjd
bear	gdaf
pocket	lldkdg
thin	ghkh
temperature	gdjldfagjfd
surprise	sjflfksd
poll	llll
proposal	lflllsal
consequence	dlhsdajdhdd
breath	gfdagh
sight	skghg
balance	galahdd
adopt	adllg
minority	jkhlfkgh
straight	sgfakghg
connect	dlhhddg
works	slfks
teaching	gdadhkhg
belong	gdllhg
aid	akd
advice	adfkdd
okay	lkah
photograph	lhlglgfalh
empty	djlgh
regional	fdgklhal
trail	gfakl
novel	hlfdl
code	dldd
somehow	sljdhls
organize	lfgahkad
jury	jjfh
breast	gfdasg
iraqi	kfaak
acknowledge	adkhlslddgd
theme	ghdjd
storm	sglfj
union	jhklh
desk	ddsk
thanks	ghahks
fruit	ffjkg
expensive	dsldhskfd
yellow	hdllls
conclusion	dlhdljsklh
prime	lfkjd
shadow	shadls
struggle	sgfjggld
conclude	dlhdljdd
analyst	ahalhsg
dance	dahdd
regulation	fdgjlagklh
being	gdkhg
ring	fkhg
largely	lafgdlh
shift	shkfg
revenue	fdfdhjd
mark	jafk
locate	lldagd
county	dljhgh
appearance	alldafahdd
package	ladkagd
difficulty	dkffkdjlgh
bridge	gfkdgd
recommend	fddljjdhd
obvious	lgfkljs
basically	gaskdallh
e-mail	d-jakl
generate	gdhdfagd
anymore	ahhjlfd
propose	lflllsd
thinking	ghkhkkhg
possibly	llsskglh
trend	gfdhd
visitor	fkskglf
loan	llah
currently	djffdhglh
comfortable	dljflfgagld
investor	khfdsglf
profit	lflfkg
angry	ahgfh
crew	dfds
accident	addkddhg
meal	jdal
hearing	hdafkhg
traffic	gfaffkd
muscle	jjsdld
notion	hlgklh
capture	dalgjfd
prefer	lfdfdf
truly	gfjlh
earth	dafgh
japanese	jalahdsd
chest	dhdsg
thick	ghkdk
cash	dash
museum	jjsdjj
beauty	gdajgh
emergency	djdfgdhdh
unique	jhkajd
internal	khgdfhal
ethnic	dghhkd
link	lkhk
stress	sgfdss
content	dlhgdhg
select	sdlddg
root	fllg
nose	hlsd
declare	dddlafd
appreciate	allfddkagd
actual	adgjal
bottle	glggld
hardly	hafdlh
setting	sdggkhg
launch	lajhdh
file	fkld
sick	skdk
outcome	ljgdljd
ad	ad
defend	ddfdhd
duty	djgh
sheet	shddg
ought	ljghg
ensure	dhsjfd
catholic	daghllkd
extremely	dsgfdjdlh
extent	dsgdhg
component	dljllhdhg
mix	jks
long-term	llhg-gdfj
slow	slls
contrast	dlhgfasg
zone	alhd
wake	sakd
airport	akfllfg
brown	gflsh
shirt	shkfg
pilot	lkllg
warn	safh
ultimately	jlgkjagdlh
cat	dag
contribution	dlhgfkgjgklh
capacity	daladkgh
ourselves	ljfsdlfds
estate	dsgagd
guide	gjkdd
circumstance	dkfdjjsgahdd
snow	shls
english	dhglksh
politician	lllkgkdkah
steal	sgdal
pursue	ljfsjd
slip	slkl
percentage	ldfddhgagd
meat	jdag
funny	fjhhh
neither	hdkghdf
soil	slkl
surgery	sjfgdfh
correct	dlffddg
jewish	jdsksh
blame	glajd
estimate	dsgkjagd
due	djd
basketball	gaskdggall
golf	gllf
investigate	khfdsgkgagd
crazy	dfaah
significantly	skghkfkdahglh
chain	dhakh
branch	gfahdh
combination	dljgkhagklh
frequently	ffdajdhglh
governor	glfdfhlf
relief	fdlkdf
user	jsdf
dad	dad
kick	kkdk
manner	jahhdf
ancient	ahdkdhg
silence	skldhdd
rating	fagkhg
golden	gllddh
motion	jlgklh
german	gdfjah
gender	gdhddf
solve	sllfd
fee	fdd
landscape	lahdsdald
used	jsdd
bowl	glsl
equal	dajal
forth	flfgh
frame	ffajd
typical	ghlkdal
except	dsddlg
conservative	dlhsdffagkfd
eliminate	dlkjkhagd
host	hlsg
hall	hall
trust	gfjsg
ocean	lddah
row	fls
producer	lfldjddf
afford	afflfd
meanwhile	jdahshkld
regime	fdgkjd
division	dkfksklh
confirm	dlhfkfj
fix	fks
appeal	alldal
mirror	jkfflf
tooth	gllgh
smart	sjafg
length	ldhggh
entirely	dhgkfdlh
rely	fdlh
topic	gllkd
complain	dljllakh
variable	fafkagld
telephone	gdldlhlhd
perception	ldfddlgklh
attract	aggfadg
confidence	dlhfkddhdd
bedroom	gddfllj
secret	sddfdg
debt	ddgg
rare	fafd
tank	gahk
nurse	hjfsd
coverage	dlfdfagd
opposition	llllskgklh
aside	askdd
anywhere	ahhshdfd
bond	glhd
pleasure	lldasjfd
master	jasgdf
era	dfa
requirement	fdajkfdjdhg
fun	fjh
expectation	dslddgagklh
wing	skhg
separate	sdlafagd
somewhat	sljdshag
pour	lljf
stir	sgkf
judgment	jjdgjdhg
beer	gddf
reference	fdfdfdhdd
tear	gdaf
doubt	dljgg
grant	gfahg
seriously	sdfkljslh
minister	jkhksgdf
totally	glgallh
hero	hdfl
industrial	khdjsgfkal
cloud	dlljd
stretch	sgfdgdh
winner	skhhdf
volume	flljjd
seed	sddd
surprised	sjflfksdd
fashion	fashklh
pepper	ldlldf
busy	gjsh
intervention	khgdffdhgklh
copy	dllh
tip	gkl
cheap	dhdal
aim	akj
cite	dkgd
welfare	sdlfafd
vegetable	fdgdgagld
gray	gfah
dish	dksh
beach	gdadh
improvement	kjlflfdjdhg
everywhere	dfdfhshdfd
opening	lldhkhg
overall	lfdfall
divide	dkfkdd
initial	khkgkal
terrible	gdffkgld
oppose	llllsd
contemporary	dlhgdjllfafh
route	fljgd
multiple	jjlgklld
essential	dssdhgkal
league	ldagjd
criminal	dfkjkhal
careful	dafdfjl
core	dlfd
upper	jlldf
rush	fjsh
necessarily	hdddssafklh
specifically	slddkfkdallh
tired	gkfdd
employ	djlllh
holiday	hllkdah
vast	fasg
resolution	fdslljgklh
household	hljsdhlld
fewer	fdsdf
abortion	aglfgklh
apart	alafg
witness	skghdss
match	jagdh
barely	gafdlh
sector	sddglf
representative	fdlfdsdhgagkfd
beneath	gdhdagh
beside	gdskdd
incident	khdkddhg
limited	lkjkgdd
proud	lfljd
flow	flls
faculty	fadjlgh
increased	khdfdasdd
waste	sasgd
merely	jdfdlh
mass	jass
emphasize	djlhaskad
experiment	dsldfkjdhg
definitely	ddfkhkgdlh
bomb	gljg
enormous	dhlfjljs
tone	glhd
liberal	lkgdfal
massive	jasskfd
engineer	dhgkhddf
wheel	shddl
decline	dddlkhd
invest	khfdsg
cable	dagld
towards	glsafds
expose	dsllsd
rural	fjfal
aids	akds
jew	jds
narrow	haffls
cream	dfdaj
secretary	sddfdgafh
gate	gagd
solid	sllkd
hill	hkll
typically	ghlkdallh
noise	hlksd
grass	gfass
unfortunately	jhflfgjhagdlh
hat	hag
legislation	ldgkslagklh
succeed	sjddddd
celebrate	ddldgfagd
achievement	adhkdfdjdhg
fishing	fkshkhg
accuse	addjsd
useful	jsdfjl
reject	fdjddg
talent	galdhg
taste	gasgd
characteristic	dhafadgdfksgkd
milk	jklk
escape	dsdald
cast	dasg
sentence	sdhgdhdd
unusual	jhjsjal
closely	dllsdlh
convince	dlhfkhdd
height	hdkghg
physician	lhhskdkah
assess	assdss
plenty	lldhgh
virtually	fkfgjallh
addition	addkgklh
sharp	shafl
creative	dfdagkfd
lower	llsdf
approve	allflfd
explanation	dsllahagklh
gay	gah
campus	dajljs
proper	lflldf
guilty	gjklgh
acquire	adajkfd
compete	dljldgd
technical	gddhhkdal
plus	lljs
immigrant	kjjkgfahg
weak	sdak
illegal	klldgal
hi	hk
alternative	algdfhagkfd
interaction	khgdfadgklh
column	dlljjh
personality	ldfslhalkgh
signal	skghal
curriculum	djffkdjljj
honor	hlhlf
passenger	lassdhgdf
assistance	assksgahdd
forever	flfdfdf
regard	fdgafd
israeli	ksfadlk
association	assldkagklh
twenty	gsdhgh
knock	khldk
wrap	sfal
lab	lag
display	dksllah
criticism	dfkgkdksj
asset	assdg
depression	ddlfdssklh
spiritual	slkfkgjal
musical	jjskdal
journalist	jljfhalksg
prayer	lfahdf
suspect	sjslddg
scholar	sdhllaf
warning	safhkhg
climate	dlkjagd
cheese	dhddsd
observation	lgsdffagklh
childhood	dhkldhlld
payment	lahjdhg
sir	skf
permit	ldfjkg
cigarette	dkgafdggd
definition	ddfkhkgklh
priority	lfklfkgh
bread	gfdad
creation	dfdagklh
graduate	gfadjagd
request	fdajdsg
emotion	djlgklh
scream	sdfdaj
dramatic	dfajagkd
universe	jhkfdfsd
gap	gal
excellent	dsddlldhg
deeply	dddllh
prosecutor	lflsddjglf
lucky	ljdkh
drag	dfag
airline	akflkhd
library	lkgfafh
agenda	agdhda
recover	fddlfdf
factory	fadglfh
selection	sdlddgklh
primarily	lfkjafklh
roof	fllf
unable	jhagld
expense	dsldhsd
initiative	khkgkagkfd
diet	dkdg
arrest	affdsg
funding	fjhdkhg
therapy	ghdfalh
wash	sash
schedule	sdhddjld
sad	sad
brief	gfkdf
housing	hljskhg
post	llsg
purchase	ljfdhasd
existing	dsksgkhg
steel	sgddl
regarding	fdgafdkhg
shout	shljg
remaining	fdjakhkhg
visual	fksjal
fairly	fakflh
chip	dhkl
violent	fklldhg
silent	skldhg
suppose	sjlllsd
self	sdlf
bike	gkkd
tea	gda
perceive	ldfddkfd
comparison	dljlafkslh
settlement	sdggldjdhg
layer	lahdf
planning	llahhkhg
description	ddsdfklgklh
slide	slkdd
widely	skddlh
wedding	sdddkhg
inform	khflfj
portion	llfgklh
territory	gdffkglfh
immediate	kjjddkagd
opponent	llllhdhg
abandon	agahdlh
lake	lakd
transform	gfahsflfj
tension	gdhsklh
leading	ldadkhg
bother	glghdf
consist	dlhsksg
alcohol	aldlhll
enable	dhagld
bend	gdhd
saving	safkhg
desert	ddsdfg
shall	shall
error	dfflf
cop	dll
arab	afag
double	dljgld
sand	sahd
spanish	slahksh
print	lfkhg
preserve	lfdsdffd
passage	lassagd
formal	flfjal
transition	gfahskgklh
existence	dsksgdhdd
album	algjj
participation	lafgkdklagklh
arrange	affahgd
atmosphere	agjlslhdfd
joint	jlkhg
reply	fdllh
cycle	dhdld
opposite	llllskgd
lock	lldk
deserve	ddsdffd
consistent	dlhsksgdhg
resistance	fdsksgahdd
discovery	dksdlfdfh
exposure	dsllsjfd
pose	llsd
stream	sgfdaj
sale	sald
pot	llg
grand	gfahd
mine	jkhd
hello	hdlll
coalition	dlalkgklh
tale	gald
knife	khkfd
resolve	fdsllfd
racial	fadkal
phase	lhasd
joke	jlkd
coat	dlag
mexican	jdskdah
symptom	shjlglj
manufacturer	jahjfadgjfdf
philosophy	lhkllsllhh
potato	llgagl
foundation	fljhdagklh
quote	ajlgd
online	lhlkhd
negotiation	hdglgkagklh
urge	jfgd
occasion	lddasklh
dust	djsg
breathe	gfdaghd
elect	dlddg
investigator	khfdsgkgaglf
jacket	jadkdg
glad	glad
ordinary	lfdkhafh
reduction	fddjdgklh
rarely	fafdlh
pack	ladk
suicide	sjkdkdd
numerous	hjjdfljs
substance	sjgsgahdd
discipline	dksdkllkhd
elsewhere	dlsdshdfd
iron	kflh
practical	lfadgkdal
moreover	jlfdlfdf
passion	lassklh
volunteer	flljhgddf
implement	kjlldjdhg
essentially	dssdhgkallh
gene	gdhd
enforcement	dhflfddjdhg
vs	fs
sauce	sajdd
independence	khddldhddhdd
marketing	jafkdgkhg
priest	lfkdsg
amazing	ajaakhg
intense	khgdhsd
advance	adfahdd
employer	djlllhdf
shock	shldk
inspire	khslkfd
adjust	adjjsg
retire	fdgkfd
visible	fkskgld
kiss	kkss
illness	kllhdss
cap	dal
habit	hagkg
competitive	dljldgkgkfd
juice	jjkdd
congressional	dlhgfdssklhal
involvement	khfllfdjdhg
dominate	dljkhagd
previously	lfdfkljslh
whenever	shdhdfdf
transfer	gfahsfdf
analyze	ahalhad
attach	aggadh
disaster	dksasgdf
parking	lafkkhg
prospect	lflslddg
boss	glss
complaint	dljllakhg
championship	dhajlklhshkl
fundamental	fjhdajdhgal
severe	sdfdfd
enhance	dhhahdd
mystery	jhsgdfh
impose	kjllsd
poverty	llfdfgh
entry	dhgfh
spending	sldhdkhg
king	kkhg
evaluate	dfaljagd
symbol	shjgll
maker	jakdf
mood	jlld
accomplish	addljllksh
emphasis	djlhasks
illustrate	klljsgfagd
boot	gllg
monitor	jlhkglf
asian	askah
entertainment	dhgdfgakhjdhg
bean	gdah
evaluation	dfaljagklh
creature	dfdagjfd
commander	dljjahddf
digital	dkgkgal
arrangement	affahgdjdhg
concentrate	dlhddhgfagd
usual	jsjal
anger	ahgdf
psychological	lshdhlllgkdal
heavily	hdafklh
peak	ldak
approximately	allflskjagdlh
increasing	khdfdaskhg
disorder	dkslfddf
missile	jksskld
equally	dajallh
vary	fafh
wire	skfd
round	fljhd
distribution	dksgfkgjgklh
transportation	gfahsllfgagklh
holy	hllh
twin	gskh
command	dljjahd
commission	dljjkssklh
interpretation	khgdflfdgagklh
breakfast	gfdakfasg
strongly	sgflhglh
engineering	dhgkhddfkhg
luck	ljdk
so-called	sl-dalldd
constant	dlhsgahg
clinic	dlkhkd
veteran	fdgdfah
smell	sjdll
tablespoon	gagldslllh
capable	dalagld
nervous	hdffljs
tourist	gljfksg
toss	glss
crucial	dfjdkal
bury	gjfh
pray	lfah
tomato	gljagl
exception	dsddlgklh
butter	gjggdf
deficit	ddfkdkg
bathroom	gaghfllj
objective	lgjddgkfd
electronic	dlddgflhkd
ally	allh
journey	jljfhdh
reputation	fdljgagklh
mixture	jksgjfd
surely	sjfdlh
tower	glsdf
smoke	sjlkd
confront	dlhfflhg
pure	ljfd
glance	glahdd
dimension	dkjdhsklh
toy	glh
prisoner	lfkslhdf
fellow	fdllls
smooth	sjllgh
nearby	hdafgh
peer	lddf
designer	ddskghdf
personnel	ldfslhhdl
educator	ddjdaglf
relative	fdlagkfd
immigration	kjjkgfagklh
belt	gdlg
teaspoon	gdaslllh
birthday	gkfghdah
implication	kjllkdagklh
perfectly	ldffddglh
coast	dlasg
supporter	sjlllfgdf
accompany	addljlahh
silver	sklfdf
teenager	gddhagdf
recognition	fddlghkgklh
retirement	fdgkfdjdhg
flag	flag
recovery	fddlfdfh
whisper	shksldf
gentleman	gdhgldjah
corn	dlfh
moon	jllh
inner	khhdf
junior	jjhklf
throat	ghflag
salary	salafh
swing	sskhg
observer	lgsdffdf
publication	ljglkdagklh
crop	dfll
dig	dkg
permanent	ldfjahdhg
phenomenon	lhdhljdhlh
anxiety	ahskdgh
unlike	jhlkkd
wet	sdg
literally	lkgdfallh
resist	fdsksg
convention	dlhfdhgklh
embrace	djgfadd
assist	assksg
exhibition	dshkgkgklh
construct	dlhsgfjdg
viewer	fkdsdf
pan	lah
consultant	dlhsjlgahg
administrator	adjkhksgfaglf
occasionally	lddasklhallh
mayor	jahlf
consideration	dlhskddfagklh
ceo	ddl
secure	sddjfd
pink	lkhk
buck	gjdk
historic	hksglfkd
poem	lldj
grandmother	gfahdjlghdf
bind	gkhd
fifth	fkfgh
constantly	dlhsgahglh
enterprise	dhgdflfksd
favor	faflf
testing	gdsgkhg
stomach	sgljadh
apparent	allafdhg
weigh	sdkgh
install	khsgall
sensitive	sdhskgkfd
suggestion	sjggdsgklh
mail	jakl
recipe	fddkld
reasonable	fdaslhagld
preparation	lfdlafagklh
wooden	sllddh
elementary	dldjdhgafh
concert	dlhddfg
aggressive	aggfdsskfd
false	falsd
intention	khgdhgklh
channel	dhahhdl
extreme	dsgfdjd
tube	gjgd
drawing	dfaskhg
protein	lflgdkh
quit	ajkg
absence	agsdhdd
latin	lagkh
rapidly	falkdlh
jail	jakl
diversity	dkfdfskgh
honest	hlhdsg
palestinian	laldsgkhkah
pace	ladd
employment	djlllhjdhg
speaker	sldakdf
impression	kjlfdssklh
essay	dssah
respondent	fdsllhddhg
giant	gkahg
cake	dakd
historian	hksglfkah
negotiate	hdglgkagd
restore	fdsglfd
substantial	sjgsgahgkal
pop	lll
specialist	slddkalksg
origin	lfkgkh
approval	allflfal
quietly	ajkdglh
advise	adfksd
conventional	dlhfdhgklhal
depth	ddlgh
wealth	sdalgh
disability	dksagklkgh
shell	shdll
criticize	dfkgkdkad
effectively	dffddgkfdlh
biological	gklllgkdal
onion	lhklh
deputy	ddljgh
flat	flag
brand	gfahd
assure	assjfd
mad	jad
award	asafd
criteria	dfkgdfka
dealer	ddaldf
via	fka
utility	jgklkgh
precisely	lfddksdlh
arise	afksd
armed	afjdd
nevertheless	hdfdfghdldss
highway	hkghsah
clinical	dlkhkdal
routine	fljgkhd
wage	sagd
normally	hlfjallh
phrase	lhfasd
ingredient	khgfddkdhg
stake	sgakd
muslim	jjslkj
fiber	fkgdf
activist	adgkfksg
islamic	kslajkd
snap	shal
terrorism	gdfflfksj
refugee	fdfjgdd
incorporate	khdlfllfagd
hip	hkl
ultimate	jlgkjagd
switch	sskgdh
corporation	dlfllfagklh
valuable	faljagld
assumption	assjjlgklh
gear	gdaf
barrier	gaffkdf
minor	jkhlf
provision	lflfksklh
killer	kklldf
assign	asskgh
gang	gahg
developing	ddfdlllkhg
classic	dlasskd
chemical	dhdjkdal
label	lagdl
teen	gddh
index	khdds
vacation	fadagklh
advocate	adfldagd
draft	dfafg
extraordinary	dsgfalfdkhafh
heaven	hdafdh
rough	fljgh
yell	hdll
pregnant	lfdghahg
distant	dksgahg
drama	dfaja
satellite	sagdllkgd
personally	ldfslhallh
clock	dlldk
chocolate	dhldllagd
italian	kgalkah
canadian	dahadkah
ceiling	ddklkhg
sweep	ssddl
advertising	adfdfgkskhg
universal	jhkfdfsal
spin	slkh
button	gjgglh
bell	gdll
rank	fahk
darkness	dafkhdss
clothing	dllghkhg
super	sjldf
yield	hkdld
fence	fdhdd
portrait	llfgfakg
survival	sjffkfal
roughly	fljghlh
lawsuit	lassjkg
testimony	gdsgkjlhh
bunch	gjhdh
found	fljhd
burden	gjfddh
react	fdadg
chamber	dhajgdf
furniture	fjfhkgjfd
cooperation	dllldfagklh
string	sgfkhg
ceremony	ddfdjlhh
communicate	dljjjhkdagd
cheek	dhddk
lost	llsg
profile	lflfkld
mechanism	jddhahksj
disagree	dksagfdd
penalty	ldhalgh
ie	kd
resort	fdslfg
destruction	ddsgfjdgklh
unlikely	jhlkkdlh
tissue	gkssjd
constitutional	dlhsgkgjgklhal
pant	lahg
stranger	sgfahgdf
infection	khfddgklh
cabinet	dagkhdg
broken	gflkdh
apple	allld
electric	dlddgfkd
proceed	lfldddd
bet	gdg
literary	lkgdfafh
virus	fkfjs
stupid	sgjlkd
dispute	dksljgd
fortune	flfgjhd
strategic	sgfagdgkd
assistant	assksgahg
overcome	lfdfdljd
remarkable	fdjafkagld
occupy	lddjlh
statistics	sgagksgkds
shopping	shlllkhg
cousin	dljskh
encounter	dhdljhgdf
wipe	skld
initially	khkgkallh
blind	glkhd
port	llfg
electricity	dlddgfkdkgh
genetic	gdhdgkd
adviser	adfksdf
spokesman	sllkdsjah
retain	fdgakh
latter	laggdf
incentive	khddhgkfd
slave	slafd
translate	gfahslagd
accurate	addjfagd
whereas	shdfdas
terror	gdfflf
expansion	dslahsklh
elite	dlkgd
olympic	llhjlkd
dirt	dkfg
odd	ldd
rice	fkdd
bullet	gjlldg
tight	gkghg
bible	gkgld
chart	dhafg
solar	sllaf
square	sajafd
concentration	dlhddhgfagklh
complicated	dljllkdagdd
gently	gdhglh
champion	dhajlklh
scenario	sddhafkl
telescope	gdldsdlld
reflection	fdflddgklh
revolution	fdflljgklh
strip	sgfkl
interpret	khgdflfdg
friendly	ffkdhdlh
tournament	gljfhajdhg
fiction	fkdgklh
detect	ddgddg
tremendous	gfdjdhdljs
lifetime	lkfdgkjd
recommendation	fddljjdhdagklh
senator	sdhaglf
hunting	hjhgkhg
salad	salad
guarantee	gjafahgdd
innocent	khhlddhg
boundary	gljhdafh
pause	lajsd
remote	fdjlgd
satisfaction	sagksfadgklh
journal	jljfhal
bench	gdhdh
lover	llfdf
raw	fas
awareness	asafdhdss
surprising	sjflfkskhg
withdraw	skghdfas
deck	dddk
similarly	skjklaflh
newly	hdslh
pole	llld
testify	gdsgkfh
mode	jldd
dialogue	dkallgjd
imply	kjllh
naturally	hagjfallh
mutual	jjgjal
founder	fljhddf
advanced	adfahddd
pride	lfkdd
dismiss	dksjkss
aircraft	akfdfafg
delivery	ddlkfdfh
mainly	jakhlh
bake	gakd
freeze	ffddad
platform	llagflfj
finance	fkhahdd
sink	skhk
attractive	aggfadgkfd
diverse	dkfdfsd
relevant	fdldfahg
ideal	kddal
joy	jlh
regularly	fdgjlaflh
working	slfkkhg
singer	skhgdf
evolve	dfllfd
shooting	shllgkhg
partly	lafglh
unknown	jhkhlsh
offense	lffdhsd
counter	dljhgdf
dna	dha
potentially	llgdhgkallh
thirty	ghkfgh
justify	jjsgkfh
protest	lflgdsg
crash	dfash
craft	dfafg
treaty	gfdagh
terrorist	gdfflfksg
insight	khskghg
possess	llssdss
politically	lllkgkdallh
tap	gal
extensive	dsgdhskfd
episode	dlksldd
swim	sskj
tire	gkfd
fault	fajlg
loose	lllsd
shortly	shlfglh
originally	lfkgkhallh
considerable	dlhskddfagld
prior	lfklf
intellectual	khgdllddgjal
assault	assajlg
relax	fdlas
stair	sgakf
adventure	adfdhgjfd
external	dsgdfhal
proof	lfllf
confident	dlhfkddhg
headquarters	hdadajafgdfs
sudden	sjdddh
dirty	dkfgh
violation	fkllagklh
tongue	glhgjd
license	lkddhsd
shelter	shdlgdf
rub	fjg
controversy	dlhgflfdfsh
entrance	dhgfahdd
properly	lflldflh
fade	fadd
defensive	ddfdhskfd
tragedy	gfagddh
net	hdg
characterize	dhafadgdfkad
funeral	fjhdfal
profession	lflfdssklh
alter	algdf
constitute	dlhsgkgjgd
establishment	dsgaglkshjdhg
squeeze	sajddad
imagination	kjagkhagklh
mask	jask
convert	dlhfdfg
comprehensive	dljlfdhdhskfd
prominent	lfljkhdhg
presentation	lfdsdhgagklh
regardless	fdgafdldss
load	llad
stable	sgagld
introduction	khgfldjdgklh
pretend	lfdgdhd
elderly	dlddflh
representation	fdlfdsdhgagklh
deer	dddf
split	sllkg
violate	fkllagd
partnership	lafghdfshkl
pollution	lllljgklh
emission	djkssklh
steady	sgdadh
vital	fkgal
fate	fagd
earnings	dafhkhgs
oven	lfdh
distinction	dksgkhdgklh
segment	sdgjdhg
nowhere	hlshdfd
poet	lldg
mere	jdfd
exciting	dsdkgkhg
variation	fafkagklh
comfort	dljflfg
radical	fadkdal
adapt	adalg
irish	kfksh
honey	hlhdh
correspondent	dlffdsllhddhg
pale	lald
musician	jjskdkah
significance	skghkfkdahdd
vessel	fdssdl
storage	sglfagd
flee	fldd
mm-hmm	jj-hjj
leather	ldaghdf
distribute	dksgfkgjgd
evolution	dflljgklh
ill	kll
tribe	gfkgd
shelf	shdlf
grandfather	gfahdfaghdf
lawn	lash
buyer	gjhdf
dining	dkhkhg
wisdom	sksdlj
council	dljhdkl
vulnerable	fjlhdfagld
instance	khsgahdd
garlic	gaflkd
capability	dalagklkgh
poetry	lldgfh
celebrity	ddldgfkgh
gradually	gfadjallh
stability	sgagklkgh
fantasy	fahgash
scared	sdafdd
plot	lllg
framework	ffajdslfk
gesture	gdsgjfd
depending	ddldhdkhg
ongoing	lhglkhg
psychology	lshdhlllgh
counselor	dljhsdllf
chapter	dhalgdf
divorce	dkflfdd
owe	lsd
pipe	lkld
athletic	aghldgkd
slight	slkghg
math	jagh
shade	shadd
tail	gakl
sustain	sjsgakh
mount	jljhg
obligation	lglkgagklh
angle	ahgld
palm	lalj
differ	dkffdf
custom	djsglj
economist	ddlhljksg
fifteen	fkfgddh
soup	sljl
celebration	ddldgfagklh
efficient	dffkdkdhg
composition	dljllskgklh
satisfy	sagksfh
pile	lkld
briefly	gfkdflh
carbon	dafglh
closer	dllsdf
consume	dlhsjjd
scheme	sdhdjd
crack	dfadk
frequency	ffdajdhdh
tobacco	glgaddl
survivor	sjffkflf
besides	gdskdds
psychologist	lshdhlllgksg
wealthy	sdalghh
galaxy	galash
given	gkfdh
ski	skk
limitation	lkjkgagklh
trace	gfadd
appointment	alllkhgjdhg
preference	lfdfdfdhdd
meter	jdgdf
explosion	dslllsklh
publicly	ljglkdlh
incredible	khdfddkgld
fighter	fkghgdf
rapid	falkd
admission	adjkssklh
hunter	hjhgdf
educate	ddjdagd
painful	lakhfjl
friendship	ffkdhdshkl
aide	akdd
infant	khfahg
calculate	daldjlagd
fifty	fkfgh
rid	fkd
porch	llfdh
tendency	gdhddhdh
uniform	jhkflfj
formation	flfjagklh
scholarship	sdhllafshkl
reservation	fdsdffagklh
efficiency	dffkdkdhdh
qualify	ajalkfh
mall	jall
derive	ddfkfd
scandal	sdahdal
pc	ld
helpful	hdllfjl
impress	kjlfdss
heel	hddl
resemble	fdsdjgld
privacy	lfkfadh
fabric	fagfkd
contest	dlhgdsg
proportion	lflllfgklh
guideline	gjkddlkhd
rifle	fkfld
maintenance	jakhgdhahdd
conviction	dlhfkdgklh
trick	gfkdk
organic	lfgahkd
tent	gdhg
examination	dsajkhagklh
publisher	ljglkshdf
strengthen	sgfdhgghdh
proposed	lflllsdd
myth	jhgh
sophisticated	sllhksgkdagdd
cow	dls
etc	dgd
standing	sgahdkhg
asleep	aslddl
tennis	gdhhks
nerve	hdffd
barrel	gaffdl
bombing	gljgkhg
membership	jdjgdfshkl
ratio	fagkl
menu	jdhj
controversial	dlhgflfdfskal
desperate	ddsldfagd
lifestyle	lkfdsghld
humor	hjjlf
loud	lljd
glove	gllfd
sufficient	sjffkdkdhg
narrative	haffagkfd
photographer	lhlglgfalhdf
helicopter	hdlkdllgdf
modest	jlddsg
provider	lflfkddf
delay	ddlah
agricultural	agfkdjlgjfal
explode	dsllldd
stroke	sgflkd
scope	sdlld
punishment	ljhkshjdhg
handful	hahdfjl
badly	gadlh
horizon	hlfkalh
curious	djfkljs
downtown	dlshglsh
girlfriend	gkflffkdhd
prompt	lfljlg
cholesterol	dhlldsgdfll
absorb	agslfg
adjustment	adjjsgjdhg
taxpayer	gaslahdf
eager	dagdf
principal	lfkhdklal
detailed	ddgakldd
motivation	jlgkfagklh
assignment	asskghjdhg
restriction	fdsgfkdgklh
laboratory	laglfaglfh
workshop	slfkshll
differently	dkffdfdhglh
auto	ajgl
romantic	fljahgkd
cotton	dlgglh
motor	jlglf
sue	sjd
flavor	flaflf
overlook	lfdflllk
float	fllag
undergo	jhddfgl
sequence	sdajdhdd
demonstration	ddjlhsgfagklh
jet	jdg
orange	lfahgd
consumption	dlhsjjlgklh
assert	assdfg
blade	gladd
temporary	gdjllfafh
medication	jddkdagklh
cabin	dagkh
bite	gkgd
edition	ddkgklh
valley	falldh
yours	hljfs
pitch	lkgdh
pine	lkhd
brilliant	gfkllkahg
versus	fdfsjs
manufacturing	jahjfadgjfkhg
absolute	agslljgd
chef	dhdf
discrimination	dksdfkjkhagklh
offensive	lffdhskfd
boom	gllj
register	fdgksgdf
appoint	alllkhg
heritage	hdfkgagd
god	gld
dominant	dljkhahg
successfully	sjdddssfjllh
shit	shkg
lemon	ldjlh
hungry	hjhgfh
wander	sahddf
submit	sjgjkg
economics	ddlhljkds
naked	hakdd
anticipate	ahgkdklagd
nut	hjg
legacy	ldgadh
extension	dsgdhsklh
shrug	shfjg
battery	gaggdfh
arrival	affkfal
legitimate	ldgkgkjagd
orientation	lfkdhgagklh
inflation	khflagklh
cope	dlld
flame	flajd
cluster	dljsgdf
wound	sljhd
dependent	ddldhddhg
shower	shlsdf
institutional	khsgkgjgklhal
depict	ddlkdg
operating	lldfagkhg
flesh	fldsh
garage	gafagd
operator	lldfaglf
instructor	khsgfjdglf
collapse	dlllalsd
borrow	glffls
furthermore	fjfghdfjlfd
comedy	dljddh
mortgage	jlfggagd
sanction	sahdgklh
civilian	dkfklkah
twelve	gsdlfd
weekly	sddklh
habitat	hagkgag
grain	gfakh
brush	gfjsh
consciousness	dlhsdkljshdss
devote	ddflgd
measurement	jdasjfdjdhg
province	lflfkhdd
ease	dasd
seize	sdkad
ethics	dghkds
nomination	hljkhagklh
permission	ldfjkssklh
wise	sksd
actress	adgfdss
summit	sjjjkg
acid	adkd
odds	ldds
gifted	gkfgdd
frustration	ffjsgfagklh
medium	jddkjj
physically	lhhskdallh
distinguish	dksgkhgjksh
shore	shlfd
repeatedly	fdldagddlh
lung	ljhg
running	fjhhkhg
distinct	dksgkhdg
artistic	afgksgkd
discourse	dksdljfsd
basket	gaskdg
ah	ah
fighting	fkghgkhg
impressive	kjlfdsskfd
competitor	dljldgkglf
ugly	jglh
worried	slffkdd
portray	llfgfah
powder	llsddf
ghost	ghlsg
persuade	ldfsjadd
moderate	jlddfagd
subsequent	sjgsdajdhg
continued	dlhgkhjdd
cookie	dllkkd
carrier	daffkdf
cooking	dllkkhg
frequent	ffdajdhg
ban	gah
awful	asfjl
admire	adjkfd
pet	ldg
miracle	jkfadld
exceed	dsdddd
rhythm	fhhghj
widespread	skddslfdad
killing	kkllkhg
lovely	llfdlh
sin	skh
charity	dhafkgh
script	sdfklg
tactic	gadgkd
identification	kddhgkfkdagklh
transformation	gfahsflfjagklh
everyday	dfdfhdah
headline	hdadlkhd
venture	fdhgjfd
invasion	khfasklh
nonetheless	hlhdghdldss
adequate	addajagd
piano	lkahl
grocery	gflddfh
intensity	khgdhskgh
exhibit	dshkgkg
blanket	glahkdg
margin	jafgkh
quarterback	ajafgdfgadk
mouse	jljsd
rope	flld
concrete	dlhdfdgd
prescription	lfdsdfklgklh
african-american	affkdah-ajdfkdah
chase	dhasd
brick	gfkdk
recruit	fddfjkg
patch	lagdh
consensus	dlhsdhsjs
horror	hlfflf
recording	fddlfdkhg
changing	dhahgkhg
painter	lakhgdf
colonial	dlllhkal
pie	lkd
sake	sakd
gaze	gaad
courage	dljfagd
pregnancy	lfdghahdh
swear	ssdaf
defeat	ddfdag
clue	dljd
reinforce	fdkhflfdd
confusion	dlhfjsklh
slice	slkdd
occupation	lddjlagklh
dear	ddaf
coal	dlal
sacred	sadfdd
formula	flfjjla
cognitive	dlghkgkfd
collective	dlllddgkfd
exact	dsadg
uncle	jhdld
captain	dalgakh
sigh	skgh
attribute	aggfkgjgd
dare	dafd
homeless	hljdldss
gallery	galldfh
soccer	sldddf
defendant	ddfdhdahg
tunnel	gjhhdl
fitness	fkghdss
lap	lal
grave	gfafd
toe	gld
container	dlhgakhdf
virtue	fkfgjd
abroad	agflad
architect	afdhkgddg
dramatically	dfajagkdallh
makeup	jakdjl
inquiry	khajkfh
rose	flsd
surprisingly	sjflfkskhglh
highlight	hkghlkghg
decrease	dddfdasd
indication	khdkdagklh
rail	fakl
anniversary	ahhkfdfsafh
couch	dljdh
alliance	allkahdd
hypothesis	hhllghdsks
boyfriend	glhffkdhd
compose	dljllsd
mess	jdss
legend	ldgdhd
regulate	fdgjlagd
adolescent	adlldsddhg
shine	shkhd
norm	hlfj
upset	jlsdg
remark	fdjafk
resign	fdskgh
reward	fdsafd
gentle	gdhgld
related	fdlagdd
organ	lfgah
lightly	lkghglh
concerning	dlhddfhkhg
invent	khfdhg
laughter	lajghgdf
northwest	hlfghsdsg
counseling	dljhsdlkhg
receiver	fdddkfdf
ritual	fkgjal
insect	khsddg
interrupt	khgdffjlg
salmon	saljlh
trading	gfadkhg
magic	jagkd
superior	sjldfklf
combat	dljgag
stem	sgdj
surgeon	sjfgdlh
acceptable	adddlgagld
physics	lhhskds
rape	fald
counsel	dljhsdl
jeans	jdahs
hunt	hjhg
continuous	dlhgkhjljs
log	llg
echo	ddhl
pill	lkll
excited	dsdkgdd
sculpture	sdjllgjfd
compound	dljlljhd
integrate	khgdgfagd
flour	flljf
bitter	gkggdf
bare	gafd
slope	sllld
rent	fdhg
presidency	lfdskddhdh
serving	sdffkhg
subtle	sjggld
greatly	gfdaglh
bishop	gkshll
drinking	dfkhkkhg
acceptance	adddlgahdd
pump	ljjl
candy	dahdh
evil	dfkl
pleased	lldasdd
medal	jddal
beg	gdg
sponsor	sllhslf
ethical	dghkdal
secondary	sddlhdafh
slam	slaj
export	dsllfg
experimental	dsldfkjdhgal
melt	jdlg
midnight	jkdhkghg
curve	djffd
integrity	khgdgfkgh
entitle	dhgkgld
evident	dfkddhg
logic	llgkd
essence	dssdhdd
exclude	dsdljdd
harsh	hafsh
closet	dllsdg
suburban	sjgjfgah
greet	gfddg
interior	khgdfklf
corridor	dlffkdlf
retail	fdgakl
pitcher	lkgdhdf
march	jafdh
snake	shakd
excuse	dsdjsd
weakness	sdakhdss
pig	lkg
classical	dlasskdal
estimated	dsgkjagdd
t-shirt	g-shkfg
unemployment	jhdjlllhjdhg
civilization	dkfklkaagklh
fold	flld
reverse	fdfdfsd
missing	jksskhg
correlation	dlffdlagklh
humanity	hjjahkgh
flash	flash
developer	ddfdllldf
reliable	fdlkagld
excitement	dsdkgdjdhg
beef	gddf
islam	kslaj
roman	fljah
architecture	afdhkgddgjfd
occasional	lddasklhal
administrative	adjkhksgfagkfd
elbow	dlgls
deadly	ddadlh
hispanic	hkslahkd
allegation	alldgagklh
confuse	dlhfjsd
airplane	akfllahd
monthly	jlhghlh
duck	djdk
dose	dlsd
korean	klfdah
plead	lldad
initiate	khkgkagd
lecture	lddgjfd
van	fah
sixth	sksgh
bay	gah
mainstream	jakhsgfdaj
suburb	sjgjfg
sandwich	sahdskdh
trunk	gfjhk
rumor	fjjlf
implementation	kjlldjdhgagklh
swallow	ssallls
motivate	jlgkfagd
render	fdhddf
longtime	llhggkjd
trap	gfal
restrict	fdsgfkdg
cloth	dllgh
seemingly	sddjkhglh
legislative	ldgkslagkfd
effectiveness	dffddgkfdhdss
enforce	dhflfdd
lens	ldhs
inspector	khslddglf
lend	ldhd
plain	llakh
fraud	ffajd
companion	dljlahklh
contend	dlhgdhd
nail	hakl
array	affah
strict	sgfkdg
assemble	assdjgld
frankly	ffahklh
rat	fag
hay	hah
hallway	hallsah
cave	dafd
inevitable	khdfkgagld
southwest	sljghsdsg
monster	jlhsgdf
unexpected	jhdslddgdd
obstacle	lgsgadld
facilitate	fadklkgagd
rip	fkl
herb	hdfg
overwhelming	lfdfshdljkhg
integration	khgdgfagklh
crystal	dfhsgal
recession	fdddssklh
written	sfkggdh
motive	jlgkfd
flood	fllld
pen	ldh
ownership	lshdfshkl
nightmare	hkghgjafd
inspection	khslddgklh
supervisor	sjldffkslf
consult	dlhsjlg
arena	afdha
diagnosis	dkaghlsks
possession	llssdssklh
forgive	flfgkfd
consistently	dlhsksgdhglh
basement	gasdjdhg
drift	dfkfg
drain	dfakh
prosecution	lflsddjgklh
maximum	jaskjjj
announcement	ahhljhddjdhg
warrior	saffklf
prediction	lfddkdgklh
bacteria	gadgdfka
questionnaire	ajdsgklhhakfd
mud	jjd
infrastructure	khffasgfjdgjfd
hurry	hjffh
privilege	lfkfkldgd
temple	gdjlld
outdoor	ljgdllf
suck	sjdk
and/or	ahd/lf
broadcast	gfladdasg
re	fd
leap	ldal
random	fahdlj
wrist	sfksg
curtain	djfgakh
pond	llhd
domain	dljakh
guilt	gjklg
cattle	daggld
walking	salkkhg
playoff	llahlff
minimum	jkhkjjj
fiscal	fksdal
skirt	skkfg
dump	djjl
hence	hdhdd
database	dagagasd
uncomfortable	jhdljflfgagld
execute	dsddjgd
limb	lkjg
ideology	kddlllgh
tune	gjhd
continuing	dlhgkhjkhg
harm	hafj
railroad	faklflad
endure	dhdjfd
radiation	fadkagklh
horn	hlfh
chronic	dhflhkd
peaceful	ldaddfjl
innovation	khhlfagklh
strain	sgfakh
guitar	gjkgaf
replacement	fdlladdjdhg
behave	gdhafd
administer	adjkhksgdf
simultaneously	skjjlgahdljslh
dancer	dahddf
amendment	ajdhdjdhg
pad	lad
transmission	gfahsjkssklh
await	asakg
retired	fdgkfdd
trigger	gfkggdf
spill	slkll
grateful	gfagdfjl
grace	gfadd
virtual	fkfgjal
colony	dlllhh
adoption	adllgklh
indigenous	khdkgdhljs
closed	dllsdd
convict	dlhfkdg
towel	glsdl
modify	jldkfh
particle	lafgkdld
prize	lfkad
landing	lahdkhg
boost	gllsg
bat	gag
alarm	alafj
festival	fdsgkfal
grip	gfkl
weird	sdkfd
undermine	jhddfjkhd
freshman	ffdshjah
sweat	ssdag
outer	ljgdf
drunk	dfjhk
separation	sdlafagklh
traditionally	gfadkgklhallh
govern	glfdfh
southeast	sljghdasg
intelligent	khgdllkgdhg
wherever	shdfdfdf
ballot	galllg
rhetoric	fhdglfkd
convinced	dlhfkhddd
driving	dfkfkhg
vitamin	fkgajkh
enthusiasm	dhghjskasj
accommodate	addljjldagd
praise	lfaksd
injure	khjjfd
wilderness	sklddfhdss
endless	dhdldss
mandate	jahdagd
respectively	fdslddgkfdlh
uncertainty	jhddfgakhgh
chaos	dhals
mechanical	jddhahkdal
canvas	dahfas
forty	flfgh
lobby	llggh
profound	lflfljhd
format	flfjag
trait	gfakg
currency	djffdhdh
turkey	gjfkdh
reserve	fdsdffd
beam	gdaj
astronomer	asgflhljdf
corruption	dlffjlgklh
contractor	dlhgfadglf
apologize	allllgkad
doctrine	dldgfkhd
genuine	gdhjkhd
thumb	ghjjg
unity	jhkgh
compromise	dljlfljksd
horrible	hlffkgld
behavioral	gdhafklfal
exclusive	dsdljskfd
scatter	sdaggdf
commonly	dljjlhlh
convey	dlhfdh
twist	gsksg
complexity	dljlldskgh
fork	flfk
disk	dksk
relieve	fdlkdfd
suspicion	sjslkdklh
health-care	hdalgh-dafd
residence	fdskddhdd
shame	shajd
meaningful	jdahkhgfjl
sidewalk	skddsalk
olympics	llhjlkds
technological	gddhhlllgkdal
signature	skghagjfd
pleasant	lldasahg
wow	sls
suspend	sjsldhd
rebel	fdgdl
frozen	ffladh
spouse	slljsd
fluid	fljkd
pension	ldhsklh
resume	fdsjjd
theoretical	ghdlfdgkdal
sodium	sldkjj
promotion	lfljlgklh
delicate	ddlkdagd
forehead	flfdhdad
rebuild	fdgjkld
bounce	gljhdd
electrical	dlddgfkdal
hook	hllk
detective	ddgddgkfd
traveler	gfafdldf
click	dlkdk
compensation	dljldhsagklh
exit	dskg
attraction	aggfadgklh
dedicate	dddkdagd
altogether	alglgdghdf
pickup	lkdkjl
carve	daffd
needle	hdddld
belly	gdllh
scare	sdafd
portfolio	llfgfllkl
shuttle	shjggld
invisible	khfkskgld
timing	gkjkhg
engagement	dhgagdjdhg
ankle	ahkld
transaction	gfahsadgklh
rescue	fdsdjd
counterpart	dljhgdflafg
historically	hksglfkdallh
firmly	fkfjlh
mild	jkld
rider	fkddf
doll	dlll
noon	hllh
amid	ajkd
identical	kddhgkdal
precise	lfddksd
anxious	ahskljs
structural	sgfjdgjfal
residential	fdskddhgkal
diagnose	dkaghlsd
carbohydrate	dafglhhdfagd
liberty	lkgdfgh
poster	llsgdf
theology	ghdlllgh
nonprofit	hlhlflfkg
crawl	dfasl
oxygen	lshgdh
handsome	hahdsljd
sum	sjj
provided	lflfkddd
businessman	gjskhdssjah
promising	lfljkskhg
conscious	dlhsdkljs
determination	ddgdfjkhagklh
donor	dlhlf
hers	hdfs
pastor	lasglf
jazz	jaaa
opera	lldfa
acquisition	adajkskgklh
pit	lkg
hug	hjg
wildlife	skldlkfd
punish	ljhksh
equity	dajkgh
doorway	dllfsah
departure	ddlafgjfd
elevator	dldfaglf
teenage	gddhagd
guidance	gjkdahdd
happiness	hallkhdss
statue	sgagjd
pursuit	ljfsjkg
repair	fdlakf
decent	ddddhg
gym	ghj
oral	lfal
clerk	dldfk
envelope	dhfdllld
reporting	fdllfgkhg
destination	ddsgkhagklh
fist	fksg
endorse	dhdlfsd
exploration	dslllfagklh
generous	gdhdfljs
bath	gagh
thereby	ghdfdgh
indicator	khdkdaglf
sunlight	sjhlkghg
feedback	fdddgadk
spectrum	slddgfjj
purple	ljflld
laser	lasdf
bold	glld
reluctant	fdljdgahg
starting	sgafgkhg
expertise	dsldfgksd
practically	lfadgkdallh
eating	dagkhg
hint	hkhg
sharply	shafllh
parade	lafadd
realm	fdalj
cancel	dahddl
blend	gldhd
therapist	ghdfalksg
peel	lddl
pizza	lkaaa
recipient	fddklkdhg
hesitate	hdskgagd
flip	flkl
accounting	addljhgkhg
bias	gkas
huh	hjh
metaphor	jdgalhlf
candle	dahdld
judicial	jjdkdkal
entity	dhgkgh
suffering	sjffdfkhg
full-time	fjll-gkjd
lamp	lajl
garbage	gafgagd
servant	sdffahg
regulatory	fdgjlaglfh
diplomatic	dkllljagkd
elegant	dldgahg
reception	fdddlgklh
vanish	fahksh
automatically	ajgljagkdallh
chin	dhkh
necessity	hdddsskgh
confess	dlhfdss
racism	fadksj
starter	sgafgdf
banking	gahkkhg
casual	dasjal
gravity	gfafkgh
enroll	dhflll
diminish	dkjkhksh
prevention	lfdfdhgklh
minimize	jkhkjkad
chop	dhll
performer	ldfflfjdf
intent	khgdhg
isolate	ksllagd
inventory	khfdhglfh
productive	lfldjdgkfd
assembly	assdjglh
civic	dkfkd
silk	sklk
magnitude	jaghkgjdd
steep	sgddl
hostage	hlsgagd
collector	dlllddglf
popularity	llljlafkgh
alien	alkdh
dynamic	dhhajkd
scary	sdafh
equation	dajagklh
angel	ahgdl
offering	lffdfkhg
rage	fagd
photography	lhlglgfalhh
toilet	glkldg
disappointed	dksalllkhgdd
precious	lfddkljs
prohibit	lflhkgkg
realistic	fdalksgkd
hidden	hkdddh
tender	gdhddf
gathering	gaghdfkhg
outstanding	ljgsgahdkhg
stumble	sgjjgld
lonely	llhdlh
automobile	ajgljlgkld
artificial	afgkfkdkal
dawn	dash
abstract	agsgfadg
descend	ddsddhd
silly	skllh
tide	gkdd
shared	shafdd
hopefully	hlldfjllh
readily	fdadklh
cooperate	dllldfagd
revolutionary	fdflljgklhafh
romance	fljahdd
hardware	hafdsafd
pillow	lkllls
kit	kkg
continent	dlhgkhdhg
seal	sdal
circuit	dkfdjkg
ruling	fjlkhg
shortage	shlfgagd
annually	ahhjallh
lately	lagdlh
scan	sdah
fool	flll
deadline	ddadlkhd
rear	fdaf
processing	lflddsskhg
ranch	fahdh
coastal	dlasgal
undertake	jhddfgakd
softly	slfglh
burning	gjfhkhg
verbal	fdfgal
tribal	gfkgal
ridiculous	fkdkdjlljs
automatic	ajgljagkd
diamond	dkajlhd
credibility	dfddkgklkgh
import	kjllfg
sexually	sdsjallh
divine	dkfkhd
sentiment	sdhgkjdhg
cart	dafg
oversee	lfdfsdd
o'clock	l'dlldk
elder	dlddf
pro	lfl
inspiration	khslkfagklh
dutch	djgdh
quantity	ajahgkgh
trailer	gfakldf
mate	jagd
greek	gfddk
genius	gdhkjs
monument	jlhjjdhg
bid	gkd
quest	ajdsg
sacrifice	sadfkfkdd
invitation	khfkgagklh
accuracy	addjfadh
juror	jjflf
officially	lffkdkallh
broker	gflkdf
treasure	gfdasjfd
loyalty	llhalgh
talented	galdhgdd
gasoline	gasllkhd
stiff	sgkff
output	ljgljg
nominee	hljkhdd
extended	dsgdhddd
diabetes	dkagdgds
slap	slal
toxic	glskd
alleged	alldgdd
jaw	jas
grief	gfkdf
mysterious	jhsgdfkljs
rocket	fldkdg
donate	dlhagd
inmate	khjagd
tackle	gadkld
dynamics	dhhajkds
bow	gls
ours	ljfs
dignity	dkghkgh
carpet	dafldg
parental	lafdhgal
bubble	gjggld
buddy	gjddh
barn	gafh
sword	sslfd
seventh	sdfdhgh
glory	gllfh
tightly	gkghglh
protective	lflgddgkfd
tuck	gjdk
drum	dfjj
faint	fakhg
queen	ajddh
dilemma	dkldjja
input	khljg
specialize	slddkalkad
northeast	hlfghdasg
shallow	shallls
liability	lkagklkgh
sail	sakl
merchant	jdfdhahg
stadium	sgadkjj
improved	kjlflfdd
bloody	gllldh
associated	assldkagdd
withdrawal	skghdfasal
refrigerator	fdffkgdfaglf
nest	hdsg
thoroughly	ghlfljghlh
lane	lahd
ancestor	ahddsglf
condemn	dlhddjh
steam	sgdaj
accent	adddhg
optimistic	llgkjksgkd
unite	jhkgd
cage	dagd
equip	dajkl
shrimp	shfkjl
homeland	hljdlahd
rack	fadk
costume	dlsgjjd
wolf	sllf
courtroom	dljfgfllj
statute	sgagjgd
cartoon	dafgllh
productivity	lfldjdgkfkgh
grin	gfkh
symbolic	shjgllkd
bug	gjg
bless	gldss
aunt	ajhg
agriculture	agfkdjlgjfd
hostile	hlsgkld
conceive	dlhddkfd
combined	dljgkhdd
instantly	khsgahglh
bankruptcy	gahkfjlgdh
vaccine	faddkhd
bonus	glhjs
collaboration	dlllaglfagklh
mixed	jksdd
opposed	llllsdd
orbit	lfgkg
grasp	gfasl
patience	lagkdhdd
spite	slkgd
tropical	gfllkdal
voting	flgkhg
patrol	lagfll
willingness	skllkhghdss
revelation	fdfdlagklh
calm	dalj
jewelry	jdsdlfh
cuban	djgah
haul	hajl
concede	dlhdddd
wagon	saglh
afterward	afgdfsafd
spectacular	slddgadjlaf
ruin	fjkh
sheer	shddf
immune	kjjjhd
reliability	fdlkagklkgh
ass	ass
alongside	allhgskdd
bush	gjsh
exotic	dslgkd
fascinating	fasdkhagkhg
clip	dlkl
thigh	ghkgh
bull	gjll
drawer	dfasdf
sheep	shddl
discourage	dksdljfagd
coordinator	dllfdkhaglf
ideological	kddlllgkdal
runner	fjhhdf
secular	sddjlaf
intimate	khgkjagd
empire	djlkfd
cab	dag
exam	dsaj
documentary	dldjjdhgafh
neutral	hdjgfal
biology	gklllgh
flexible	fldskgld
progressive	lflgfdsskfd
web	sdg
conspiracy	dlhslkfadh
casualty	dasjalgh
republic	fdljglkd
execution	dsddjgklh
terrific	gdffkfkd
whale	shald
functional	fjhdgklhal
instinct	khsgkhdg
teammate	gdajjagd
aluminum	aljjkhjj
whoever	shldfdf
ministry	jkhksgfh
verdict	fdfdkdg
instruct	khsgfjdg
skull	skjll
self-esteem	sdlf-dsgddj
cooperative	dllldfagkfd
manipulate	jahkljlagd
bee	gdd
practitioner	lfadgkgklhdf
loop	llll
edit	ddkg
whip	shkl
puzzle	ljaald
mushroom	jjshfllj
subsidy	sjgskdh
boil	glkl
tragic	gfagkd
mathematics	jaghdjagkds
mechanic	jddhahkd
jar	jaf
earthquake	dafghajakd
pork	llfk
creativity	dfdagkfkgh
safely	safdlh
underlying	jhddflhkhg
dessert	ddssdfg
sympathy	shjlaghh
fisherman	fkshdfjah
incredibly	khdfddkglh
isolation	ksllagklh
sock	sldk
eleven	dldfdh
sexy	sdsh
entrepreneur	dhgfdlfdhdjf
syndrome	shhdfljd
bureau	gjfdaj
workplace	slfklladd
ambition	ajgkgklh
touchdown	gljdhdlsh
utilize	jgklkad
breeze	gfddad
costly	dlsglh
ambitious	ajgkgkljs
christianity	dhfksgkahkgh
presumably	lfdsjjaglh
influential	khfljdhgkal
translation	gfahslagklh
uncertain	jhddfgakh
dissolve	dkssllfd
statistical	sgagksgkdal
gut	gjg
metropolitan	jdgfllllkgah
rolling	flllkhg
aesthetic	adsghdgkd
spell	sldll
insert	khsdfg
booth	gllgh
helmet	hdljdg
waist	saksg
expected	dslddgdd
lion	lklh
accomplishment	addljllkshjdhg
royal	flhal
panic	lahkd
crush	dfjsh
actively	adgkfdlh
cliff	dlkff
minimal	jkhkjal
cord	dlfd
fortunately	flfgjhagdlh
cocaine	dldakhd
illusion	klljsklh
anonymous	ahlhhjljs
tolerate	glldfagd
appreciation	allfddkagklh
commissioner	dljjkssklhdf
flexibility	fldskgklkgh
instructional	khsgfjdgklhal
scramble	sdfajgld
casino	daskhl
tumor	gjjlf
decorate	dddlfagd
pulse	ljlsd
equivalent	dajkfaldhg
fixed	fksdd
experienced	dsldfkdhddd
donation	dlhagklh
diary	dkafh
sibling	skglkhg
irony	kflhh
spoon	slllh
midst	jkdsg
alley	alldh
interact	khgdfadg
soap	slal
cute	djgd
rival	fkfal
short-term	shlfg-gdfj
punch	ljhdh
pin	lkh
hockey	hldkdh
passing	lasskhg
persist	ldfsksg
supplier	sjlllkdf
known	khlsh
momentum	jljdhgjj
purse	ljfsd
shed	shdd
liquid	lkajkd
icon	kdlh
elephant	dldlhahg
consequently	dlhsdajdhglh
legislature	ldgkslagjfd
franchise	ffahdhksd
correctly	dlffddglh
mentally	jdhgallh
foster	flsgdf
bicycle	gkdhdld
encouraging	dhdljfagkhg
cheat	dhdag
heal	hdal
fever	fdfdf
filter	fklgdf
rabbit	faggkg
coin	dlkh
exploit	dslllkg
accessible	adddsskgld
organism	lfgahksj
sensation	sdhsagklh
partially	lafgkallh
upstairs	jlsgakfs
dried	dfkdd
conservation	dlhsdffagklh
shove	shlfd
backyard	gadkhafd
charter	dhafgdf
stove	sglfd
consent	dlhsdhg
comprise	dljlfksd
reminder	fdjkhddf
alike	alkkd
placement	lladdjdhg
dough	dljgh
grandchild	gfahddhkld
dam	daj
reportedly	fdllfgddlh
well-known	sdll-khlsh
surrounding	sjffljhdkhg
ecological	ddlllgkdal
outfit	ljgfkg
unprecedented	jhlfdddddhgdd
columnist	dlljjhksg
workout	slfkljg
preliminary	lfdlkjkhafh
patent	lagdhg
shy	shh
trash	gfash
disabled	dksagldd
gross	gflss
damn	dajh
hormone	hlfjlhd
texture	gdsgjfd
pencil	ldhdkl
frontier	fflhgkdf
spray	slfah
disclose	dksdllsd
custody	djsgldh
banker	gahkdf
beast	gdasg
interfere	khgdffdfd
oak	lak
eighth	dkghgh
notebook	hlgdgllk
outline	ljglkhd
attendance	aggdhdahdd
speculation	slddjlagklh
uncover	jhdlfdf
behalf	gdhalf
innovative	khhlfagkfd
shark	shafk
mill	jkll
installation	khsgallagklh
stimulate	sgkjjlagd
tag	gag
vertical	fdfgkdal
swimming	sskjjkhg
fleet	flddg
catalog	dagallg
outsider	ljgskddf
desperately	ddsldfagdlh
stance	sgahdd
compel	dljldl
sensitivity	sdhskgkfkgh
someday	sljddah
instant	khsgahg
debut	ddgjg
proclaim	lfldlakj
worldwide	slfldskdd
hike	hkkd
required	fdajkfdd
confrontation	dlhfflhgagklh
colorful	dlllffjl
constitution	dlhsgkgjgklh
trainer	gfakhdf
thanksgiving	ghahksgkfkhg
scent	sddhg
stack	sgadk
eyebrow	dhdgfls
sack	sadk
cease	ddasd
inherit	khhdfkg
tray	gfah
pioneer	lklhddf
organizational	lfgahkaagklhal
textbook	gdsggllk
uh	jh
nasty	hasgh
shrink	shfkhk
emerging	djdfgkhg
dot	dlg
wheat	shdag
fierce	fkdfdd
envision	dhfksklh
rational	fagklhal
kingdom	kkhgdlj
aisle	aksld
weaken	sdakdh
protocol	lflgldll
exclusively	dsdljskfdlh
vocal	fldal
marketplace	jafkdglladd
openly	lldhlh
unfair	jhfakf
terrain	gdffakh
deploy	ddlllh
risky	fkskh
pasta	lasga
genre	gdhfd
distract	dksgfadg
merit	jdfkg
planner	llahhdf
depressed	ddlfdssdd
chunk	dhjhk
closest	dllsdsg
discount	dksdljhg
ladder	ladddf
jungle	jjhgld
migration	jkgfagklh
breathing	gfdaghkhg
invade	khfadd
hurricane	hjffkdahd
retailer	fdgakldf
classify	dlasskfh
coup	dljl
ambassador	ajgassadlf
density	ddhskgh
supportive	sjlllfgkfd
curiosity	djfklskgh
skip	skkl
aggression	aggfdssklh
stimulus	sgkjjljs
journalism	jljfhalksj
robot	flglg
dip	dkl
likewise	lkkdsksd
informal	khflfjal
persian	ldfskah
feather	fdaghdf
sphere	slhdfd
tighten	gkghgdh
boast	glasg
pat	lag
perceived	ldfddkfdd
sole	slld
publicity	ljglkdkgh
unfold	jhflld
well-being	sdll-gdkhg
validity	falkdkgh
ecosystem	ddlshsgdj
strictly	sgfkdglh
partial	lafgkal
collar	dlllaf
weed	sddd
compliance	dljllkahdd
streak	sgfdak
supposedly	sjlllsddlh
added	adddd
builder	gjklddf
glimpse	glkjlsd
premise	lfdjksd
specialty	slddkalgh
deem	dddj
artifact	afgkfadg
sneak	shdak
monkey	jlhkdh
mentor	jdhglf
two-thirds	gsl-ghkfds
listener	lksgdhdf
lightning	lkghghkhg
legally	ldgallh
sleeve	slddfd
disappointment	dksalllkhgjdhg
disturb	dksgjfg
rib	fkg
excessive	dsddsskfd
high-tech	hkgh-gddh
debris	ddgfks
rod	fld
logical	llgkdal
ash	ash
socially	sldkallh
parish	lafksh
slavery	slafdfh
blank	glahk
commodity	dljjldkgh
cure	djfd
mineral	jkhdfal
hunger	hjhgdf
dying	dhkhg
developmental	ddfdllljdhgal
faster	fasgdf
spare	slafd
halfway	halfsah
equality	dajalkgh
cemetery	ddjdgdfh
harassment	hafassjdhg
deliberately	ddlkgdfagdlh
fame	fajd
regret	fdgfdg
striking	sgfkkkhg
likelihood	lkkdlkhlld
carrot	dafflg
atop	agll
toll	glll
rim	fkj
embarrassed	djgaffassdd
fucking	fjdkkhg
cling	dlkhg
isolated	ksllagdd
blink	glkhk
suspicious	sjslkdkljs
wheelchair	shddldhakf
squad	sajad
eligible	dlkgkgld
processor	lflddsslf
plunge	lljhgd
demographic	ddjlgfalhkd
chill	dhkll
refuge	fdfjgd
steer	sgddf
legislator	ldgkslaglf
rally	fallh
programming	lflgfajjkhg
cheer	dhddf
outlet	ljgldg
intact	khgadg
vendor	fdhdlf
thrive	ghfkfd
peanut	ldahjg
chew	dhds
elaborate	dlaglfagd
conception	dlhddlgklh
auction	ajdgklh
steak	sgdak
comply	dljllh
triumph	gfkjjlh
shareholder	shafdhllddf
comparable	dljlafagld
transport	gfahsllfg
conscience	dlhsdkdhdd
calculation	daldjlagklh
considerably	dlhskddfaglh
interval	khgdffal
scratch	sdfagdh
awake	asakd
jurisdiction	jjfksdkdgklh
inevitably	khdfkgaglh
feminist	fdjkhksg
constraint	dlhsgfakhg
emotionally	djlgklhallh
expedition	dslddkgklh
allegedly	alldgddlh
similarity	skjklafkgh
butt	gjgg
lid	lkd
dumb	djjg
bulk	gjlk
sprinkle	slfkhkld
mortality	jlfgalkgh
philosophical	lhkllsllhkdal
conversion	dlhfdfsklh
patron	lagflh
municipal	jjhkdklal
liver	lkfdf
harmony	hafjlhh
solely	slldlh
tolerance	glldfahdd
goat	glag
blessing	gldsskhg
banana	gahaha
palace	laladd
formerly	flfjdflh
peasant	ldasahg
neat	hdag
grandparent	gfahdlafdhg
lawmaker	lasjakdf
supermarket	sjldfjafkdg
cruise	dfjksd
mobile	jlgkld
calendar	daldhdaf
widow	skdls
deposit	ddllskg
beard	gdafd
brake	gfakd
screening	sdfddhkhg
impulse	kjljlsd
forbid	flfgkd
fur	fjf
brutal	gfjgal
predator	lfddaglf
poke	llkd
opt	llg
voluntary	flljhgafh
valid	falkd
forum	flfjj
dancing	dahdkhg
happily	hallklh
soar	slaf
removal	fdjlfal
autonomy	ajglhljh
enact	dhadg
thread	ghfdad
landmark	lahdjafk
unhappy	jhhallh
offender	lffdhddf
coming	dljkhg
privately	lfkfagdlh
fraction	ffadgklh
distinctive	dksgkhdgkfd
tourism	gljfksj
threshold	ghfdshlld
routinely	fljgkhdlh
suite	sjkgd
regulator	fdgjlaglf
straw	sgfas
theological	ghdlllgkdal
exhaust	dshajsg
globe	gllgd
fragile	ffagkld
objection	lgjddgklh
chemistry	dhdjksgfh
old-fashioned	lld-fashklhdd
crowded	dflsddd
blast	glasg
prevail	lfdfakl
overnight	lfdfhkghg
denial	ddhkal
rental	fdhgal
fantastic	fahgasgkd
fragment	ffagjdhg
screw	sdfds
warmth	safjgh
undergraduate	jhddfgfadjagd
headache	hdadadhd
policeman	lllkddjah
projection	lfljddgklh
suitable	sjkgagld
graduation	gfadjagklh
drill	dfkll
cruel	dfjdl
mansion	jahsklh
grape	gfald
authorize	ajghlfkad
cottage	dlggagd
driveway	dfkfdsah
charm	dhafj
sexuality	sdsjalkgh
loyal	llhal
clay	dlah
balloon	gallllh
invention	khfdhgklh
ego	dgl
fare	fafd
homework	hljdslfk
disc	dksd
sofa	slfa
availability	afaklagklkgh
radar	fadaf
frown	fflsh
regain	fdgakh
sweater	ssdagdf
rehabilitation	fdhagklkgagklh
rubber	fjggdf
retreat	fdgfdag
molecule	jllddjld
freely	ffddlh
favorable	faflfagld
steadily	sgdadklh
integrated	khgdgfagdd
ha	ha
youngster	hljhgsgdf
premium	lfdjkjj
accountability	addljhgagklkgh
overwhelm	lfdfshdlj
one-third	lhd-ghkfd
contemplate	dlhgdjllagd
update	jldagd
spark	slafk
ironically	kflhkdallh
fatigue	fagkgjd
speculate	slddjlagd
marker	jafkdf
preach	lfdadh
bucket	gjdkdg
blond	gllhd
confession	dlhfdssklh
provoke	lflflkd
marble	jafgld
substantially	sjgsgahgkallh
defender	ddfdhddf
explicit	dsllkdkg
disturbing	dksgjfgkhg
surveillance	sjffdkllahdd
magnetic	jaghdgkd
technician	gddhhkdkah
mutter	jjggdf
devastating	ddfasgagkhg
depart	ddlafg
arrow	affls
trauma	gfajja
neighboring	hdkghglfkhg
soak	slak
ribbon	fkgglh
meantime	jdahgkjd
transmit	gfahsjkg
harvest	haffdsg
consecutive	dlhsddjgkfd
coordinate	dllfdkhagd
spy	slh
slot	sllg
riot	fklg
nutrient	hjgfkdhg
citizenship	dkgkadhshkl
severely	sdfdfdlh
sovereignty	slfdfdkghgh
ridge	fkdgd
brave	gfafd
lighting	lkghgkhg
specify	slddkfh
contributor	dlhgfkgjglf
frustrate	ffjsgfagd
articulate	afgkdjlagd
importantly	kjllfgahglh
transit	gfahskg
dense	ddhsd
seminar	sdjkhaf
electronics	dlddgflhkds
sunny	sjhhh
shorts	shlfgs
swell	ssdll
accusation	addjsagklh
soften	slfgdh
straighten	sgfakghgdh
terribly	gdffkglh
cue	djd
bride	gfkdd
biography	gklgfalhh
hazard	haaafd
compelling	dljldllkhg
seldom	sdldlj
tile	gkld
economically	ddlhljkdallh
honestly	hlhdsglh
troubled	gfljgldd
twentieth	gsdhgkdgh
balanced	galahddd
foreigner	flfdkghdf
convenience	dlhfdhkdhdd
delight	ddlkghg
weave	sdafd
timber	gkjgdf
till	gkll
accurately	addjfagdlh
plea	llda
bulb	gjlg
flying	flhkhg
sustainable	sjsgakhagld
devil	ddfkl
bolt	gllg
cargo	dafgl
spine	slkhd
seller	sdlldf
skilled	skklldd
managing	jahagkhg
marine	jafkhd
dock	dldk
organized	lfgahkadd
fog	flg
diplomat	dkllljag
boring	glfkhg
sometime	sljdgkjd
summary	sjjjafh
missionary	jkssklhafh
epidemic	dlkddjkd
fatal	fagal
trim	gfkj
warehouse	safdhljsd
accelerate	adddldfagd
butterfly	gjggdfflh
bronze	gflhad
drown	dflsh
inherent	khhdfdhg
nationwide	hagklhskdd
spit	slkg
kneel	khddl
vacuum	fadjjj
selected	sdlddgdd
dictate	dkdgagd
