the	fjd
be	fd
and	ajd
of	lf
a	a
in	kj
to	fl
have	jafd
it	kf
i	k
that	fjaf
for	flf
you	jlj
he	jd
with	skfj
on	lj
do	dl
say	saj
this	fjks
they	fjdj
at	af
but	fjf
we	sd
his	jks
from	fflj
not	jlf
by	fj
she	sjd
or	lf
as	as
what	sjaf
go	fl
their	fjdkf
can	daj
who	sjl
get	fdf
if	kf
would	sljld
her	jdf
all	all
my	jj
make	jakd
about	afljf
know	kjls
will	skll
up	j;
one	ljd
time	fkjd
there	fjdfd
year	jdaf
so	sl
think	fjkjk
when	sjdj
which	sjkdj
them	fjdj
some	sljd
me	jd
people	;dl;ld
take	fakd
out	ljf
into	kjfl
just	jjsf
see	sdd
him	jkj
your	jljf
come	dljd
could	dljld
now	jls
than	fjaj
like	lkkd
other	lfjdf
how	jls
then	fjdj
its	kfs
our	ljf
two	fsl
more	jlfd
these	fjdsd
want	sajf
way	saj
look	lllk
first	fkfsf
also	alsl
new	jds
because	fddajsd
day	daj
use	jsd
no	jl
man	jaj
find	fkjd
here	jdfd
thing	fjkjf
give	fkfd
many	jajj
well	sdll
only	ljlj
those	fjlsd
tell	fdll
very	fdfj
even	dfdj
back	fadk
any	ajj
good	flld
woman	sljaj
through	fjfljfj
us	js
life	lkfd
child	djkld
work	slfk
down	dlsj
may	jaj
after	affdf
should	sjljld
call	dall
world	slfld
over	lfdf
school	sdjlll
still	sfkll
try	ffj
last	lasf
ask	ask
need	jddd
too	fll
feel	fddl
three	fjfdd
state	sfafd
never	jdfdf
become	fddljd
between	fdfsddj
high	jkfj
really	fdallj
something	sljdfjkjf
most	jlsf
another	ajlfjdf
much	jjdj
family	fajklj
own	lsj
leave	ldafd
put	;jf
old	lld
while	sjkld
mean	jdaj
keep	kdd;
student	sfjddjf
why	sjj
let	ldf
great	ffdaf
same	sajd
big	fkf
group	fflj;
begin	fdfkj
seem	sddj
country	dljjffj
help	jdl;
talk	falk
where	sjdfd
turn	fjfj
problem	;flfldj
every	dfdfj
start	sfaff
hand	jajd
might	jkfjf
american	ajdfkdaj
show	sjls
part	;aff
against	afakjsf
place	;ladd
such	sjdj
again	afakj
few	fds
case	dasd
week	sddk
company	dlj;ajj
system	sjsfdj
each	dadj
right	fkfjf
program	;flffaj
hear	jdaf
question	ajdsfklj
during	djfkjf
play	;laj
government	flfdfjjdjf
run	fjj
small	sjall
number	jjjfdf
off	lff
always	alsajs
move	jlfd
night	jkfjf
live	lkfd
mr	jf
point	;lkjf
believe	fdlkdfd
hold	jlld
today	fldaj
bring	ffkjf
happen	ja;;dj
next	jdsf
without	skfjljf
before	fdflfd
large	laffd
million	jkllklj
must	jjsf
home	jljd
under	jjddf
water	safdf
room	fllj
write	sfkfd
mother	jlfjdf
area	afda
national	jafkljal
money	jljdj
story	sflfj
young	jljjf
fact	fadf
month	jljfj
different	dkffdfdjf
lot	llf
study	sfjdj
book	fllk
eye	djd
job	jlf
word	slfd
though	fjljfj
business	fjskjdss
issue	kssjd
side	skdd
kind	kkjd
four	fljf
head	jdad
far	faf
black	fladk
long	lljf
both	flfj
little	lkffld
house	jljsd
yes	jds
since	skjdd
provide	;flfkdd
service	sdffkdd
around	afljjd
friend	ffkdjd
important	kj;lffajf
father	fafjdf
sit	skf
away	asaj
until	jjfkl
power	;lsdf
hour	jljf
game	fajd
often	lffdj
yet	jdf
line	lkjd
political	;llkfkdal
end	djd
among	ajljf
ever	dfdf
stand	sfajd
bad	fad
lose	llsd
however	jlsdfdf
member	jdjfdf
pay	;aj
law	las
meet	jddf
car	daf
city	dkfj
almost	aljlsf
include	kjdljdd
continue	dljfkjjd
set	sdf
later	lafdf
community	dljjjjkfj
name	jajd
five	fkfd
once	ljdd
white	sjkfd
least	ldasf
president	;fdskddjf
learn	ldafj
real	fdal
change	djajfd
team	fdaj
minute	jkjjfd
best	fdsf
several	sdfdfal
idea	kdda
kid	kkd
body	fldj
information	kjflfjafklj
nothing	jlfjkjf
ago	afl
lead	ldad
social	sldkal
understand	jjddfsfajd
whether	sjdfjdf
watch	safdj
together	flfdfjdf
follow	flllls
parent	;afdjf
stop	sfl;
face	fadd
anything	ajjfjkjf
create	dfdafd
public	;jflkd
already	alfdadj
speak	s;dak
others	lfjdfs
read	fdad
level	ldfdl
allow	allls
add	add
office	lffkdd
spend	s;djd
door	dllf
health	jdalfj
person	;dfslj
art	aff
sure	sjfd
war	saf
history	jksflfj
party	;affj
within	skfjkj
grow	ffls
result	fdsjlf
open	l;dj
morning	jlfjkjf
walk	salk
reason	fdaslj
low	lls
win	skj
research	fdsdafdj
girl	fkfl
guy	fjj
early	daflj
food	flld
moment	jljdjf
himself	jkjsdlf
air	akf
teacher	fdadjdf
force	flfdd
offer	lffdf
enough	djljfj
education	ddjdafklj
across	adflss
although	alfjljfj
remember	fdjdjfdf
foot	fllf
second	sddljd
boy	flj
maybe	jajfd
toward	flsafd
able	afld
age	afd
policy	;llkdj
everything	dfdfjfjkjf
love	llfd
process	;flddss
music	jjskd
including	kjdljdkjf
consider	dljskddf
appear	a;;daf
actually	adfjallj
buy	fjj
probably	;flfaflj
human	jjjaj
wait	sakf
serve	sdffd
market	jafkdf
die	dkd
send	sdjd
expect	ds;ddf
sense	sdjsd
build	fjkld
stay	sfaj
fall	fall
oh	lj
nation	jafklj
plan	;laj
cut	djf
college	dllldfd
interest	kjfdfdsf
death	ddafj
course	dljfsd
someone	sljdljd
experience	ds;dfkdjdd
behind	fdjkjd
reach	fdadj
local	lldal
kill	kkll
six	sks
remain	fdjakj
effect	dffddf
yeah	jdaj
suggest	sjffdsf
class	dlass
control	dljffll
raise	faksd
care	dafd
perhaps	;dfja;s
late	lafd
hard	jafd
field	fkdld
else	dlsd
pass	;ass
former	flfjdf
sell	sdll
major	jajlf
sometimes	sljdfkjds
require	fdajkfd
along	alljf
development	ddfdll;jdjf
themselves	fjdjsdlfds
report	fd;lff
role	flld
better	fdffdf
economic	ddljljkd
effort	dfflff
decide	dddkdd
rate	fafd
strong	sffljf
possible	;lsskfld
heart	jdaff
drug	dfjf
leader	ldaddf
light	lkfjf
voice	flkdd
wife	skfd
whole	sjlld
police	;llkdd
mind	jkjd
finally	fkjallj
pull	;jll
return	fdfjfj
free	ffdd
military	jklkfafj
price	;fkdd
less	ldss
according	addlfdkjf
decision	dddksklj
explain	ds;lakj
son	slj
hope	jl;d
develop	ddfdll;
view	fkds
relationship	fdlafkljsjk;
carry	daffj
town	flsj
road	flad
drive	dfkfd
arm	afj
true	ffjd
federal	fdddfal
break	ffdak
difference	dkffdfdjdd
thank	fjajk
receive	fdddkfd
value	faljd
international	kjfdfjafkljal
building	fjkldkjf
action	adfklj
full	fjll
model	jlddl
join	jlkj
season	sdaslj
society	sldkdfj
tax	fas
director	dkfddflf
position	;lskfklj
player	;lajdf
agree	affdd
especially	ds;ddkallj
record	fddlfd
pick	;kdk
wear	sdaf
paper	;a;df
special	s;ddkal
space	s;add
ground	ffljjd
form	flfj
support	sj;;lff
event	dfdjf
official	lffkdkal
whose	sjlsd
matter	jaffdf
everyone	dfdfjljd
center	ddjfdf
couple	dlj;ld
site	skfd
project	;fljddf
hit	jkf
base	fasd
activity	adfkfkfj
star	sfaf
table	fafld
court	dljff
produce	;fldjdd
eat	daf
teach	fdadj
oil	lkl
half	jalf
situation	skfjafklj
easy	dasj
cost	dlsf
industry	kjdjsffj
figure	fkfjfd
street	sffddf
image	kjafd
itself	kfsdlf
phone	;jljd
either	dkfjdf
data	dafa
cover	dlfdf
quite	ajkfd
picture	;kdfjfd
clear	dldaf
practice	;fadfkdd
piece	;kddd
land	lajd
recent	fdddjf
describe	ddsdfkfd
product	;fldjdf
doctor	dldflf
wall	sall
patient	;afkdjf
worker	slfkdf
news	jdss
test	fdsf
movie	jlfkd
certain	ddffakj
north	jlffj
personal	;dfsljal
simply	skj;lj
third	fjkfd
technology	fddjjlllfj
catch	dafdj
step	sfd;
baby	fafj
computer	dlj;jfdf
type	fj;d
attention	affdjfklj
draw	dfas
film	fklj
republican	fd;jflkdaj
tree	ffdd
source	sljfdd
red	fdd
nearly	jdaflj
organization	lffajkaafklj
choose	djllsd
cause	dajsd
hair	jakf
century	ddjfjfj
evidence	dfkddjdd
window	skjdls
difficult	dkffkdjlf
listen	lksfdj
soon	sllj
culture	djlfjfd
billion	fkllklj
chance	djajdd
brother	fflfjdf
energy	djdffj
period	;dfkld
summer	sjjjdf
realize	fdalkad
hundred	jjjdfdd
available	afaklafld
plant	;lajf
likely	lkkdlj
opportunity	l;;lffjjkfj
term	fdfj
short	sjlff
letter	ldffdf
condition	dljdkfklj
choice	djlkdd
single	skjfld
rule	fjld
daughter	dajfjfdf
administration	adjkjksffafklj
south	sljfj
husband	jjsfajd
congress	dljffdss
floor	flllf
campaign	daj;akfj
material	jafdfkal
population	;l;jlafklj
economy	ddljljj
medical	jddkdal
hospital	jls;kfal
church	djjfdj
close	dllsd
thousand	fjljsajd
risk	fksk
current	djffdjf
fire	fkfd
future	fjfjfd
wrong	sfljf
involve	kjfllfd
defense	ddfdjsd
anyone	ajjljd
increase	kjdfdasd
security	sddjfkfj
bank	fajk
myself	jjsdlf
certainly	ddffakjlj
west	sdsf
sport	s;lff
board	flafd
seek	sddk
per	;df
subject	sjfjddf
officer	lffkddf
private	;fkfafd
rest	fdsf
behavior	fdjafklf
deal	ddal
performance	;dfflfjajdd
fight	fkfjf
throw	fjfls
top	fl;
quickly	ajkdklj
past	;asf
goal	flal
bed	fdd
order	lfddf
author	ajfjlf
fill	fkll
represent	fd;fdsdjf
focus	fldjs
foreign	flfdkfj
drop	dfl;
blood	fllld
upon	j;lj
agency	afdjdj
push	;jsj
nature	jafjfd
color	dlllf
recently	fdddjflj
store	sflfd
reduce	fddjdd
sound	sljjd
note	jlfd
fine	fkjd
near	jdaf
movement	jlfdjdjf
page	;afd
enter	djfdf
share	sjafd
common	dljjlj
poor	;llf
natural	jafjfal
race	fadd
concern	dljddfj
series	sdfkds
significant	skfjkfkdajf
similar	skjklaf
hot	jlf
language	lajfjafd
usually	jsjallj
response	fds;ljsd
dead	ddad
rise	fksd
animal	ajkjal
factor	fadflf
decade	dddadd
article	affkdld
shoot	sjllf
east	dasf
save	safd
seven	sdfdj
artist	affksf
scene	sddjd
stock	sfldk
career	dafddf
despite	dds;kfd
central	ddjffal
eight	dkfjf
thus	fjjs
treatment	ffdafjdjf
beyond	fdjljd
happy	ja;;j
exactly	dsadflj
protect	;flfddf
approach	a;;fladj
lie	lkd
size	skad
dog	dlf
fund	fjjd
serious	sdfkljs
occur	lddjf
media	jddka
ready	fdadj
sign	skfj
thought	fjljfjf
list	lksf
individual	kjdkfkdjal
simple	skj;ld
quality	ajalkfj
pressure	;fdssjfd
accept	addd;f
answer	ajssdf
resource	fdsljfdd
identify	kddjfkfj
left	ldff
meeting	jddfkjf
determine	ddfdfjkjd
prepare	;fd;afd
disease	dksdasd
whatever	sjafdfdf
success	sjdddss
argue	affjd
cup	dj;
particularly	;affkdjlaflj
amount	ajljjf
ability	afklkfj
staff	sfaff
recognize	fddlfjkad
indicate	kjdkdafd
character	djafadfdf
growth	fflsfj
loss	llss
degree	ddffdd
wonder	sljddf
attack	affadk
herself	jdfsdlf
region	fdfklj
television	fdldfksklj
box	fls
tv	ff
training	ffakjkjf
pretty	;fdffj
trade	ffadd
election	dlddfklj
everybody	dfdfjfldj
physical	;jjskdal
lay	laj
general	fdjdfal
feeling	fddlkjf
standard	sfajdafd
bill	fkll
message	jdssafd
fail	fakl
outside	ljfskdd
arrive	affkfd
analysis	ajaljsks
benefit	fdjdfkf
sex	sds
forward	flfsafd
lawyer	lasjdf
present	;fdsdjf
section	sddfklj
environmental	djfkfljjdjfal
glass	flass
skill	skkll
sister	sksfdf
pm	;j
professor	;flfdsslf
operation	l;dfafklj
financial	fkjajdkal
crime	dfkjd
stage	sfafd
ok	lk
compare	dlj;afd
authority	ajfjlfkfj
miss	jkss
design	ddskfj
sort	slff
act	adf
ten	fdj
knowledge	kjlslddfd
gun	fjj
station	sfafklj
blue	fljd
strategy	sffafdfj
clearly	dldaflj
discuss	dksdjss
indeed	kjdddd
truth	ffjfj
song	sljf
example	dsaj;ld
democratic	ddjldfafkd
check	djddk
environment	djfkfljjdjf
leg	ldf
dark	dafk
various	fafkljs
rather	fafjdf
laugh	lajfj
guess	fjdss
executive	dsddjfkfd
prove	;flfd
hang	jajf
entire	djfkfd
rock	fldk
forget	flffdf
claim	dlakj
remove	fdjlfd
manager	jajafdf
enjoy	djjlj
network	jdfslfk
legal	ldfal
religious	fdlkfkljs
cold	dlld
final	fkjal
main	jakj
science	sdkdjdd
green	ffddj
memory	jdjlfj
card	dafd
above	aflfd
seat	sdaf
cell	ddll
establish	dsfaflksj
nice	jkdd
trial	ffkal
expert	ds;dff
spring	s;fkjf
firm	fkfj
democrat	ddjldfaf
radio	fadkl
visit	fkskf
management	jajafdjdjf
avoid	aflkd
imagine	kjafkjd
tonight	fljkfjf
huge	jjfd
ball	fall
finish	fkjksj
yourself	jljfsdlf
theory	fjdlfj
impact	kj;adf
respond	fds;ljd
statement	sfafdjdjf
maintain	jakjfakj
charge	djaffd
popular	;l;jlaf
traditional	ffadkfkljal
onto	ljfl
reveal	fdfdal
direction	dkfddfklj
weapon	sda;lj
employee	dj;lljdd
cultural	djlfjfal
contain	dljfakj
peace	;dadd
pain	;akj
apply	a;;lj
measure	jdasjfd
wide	skdd
shake	sjakd
fly	flj
interview	kjfdffkds
manage	jajafd
chair	djakf
fish	fksj
particular	;affkdjlaf
camera	dajdfa
structure	sffjdfjfd
politics	;llkfkds
perform	;dfflfj
bit	fkf
weight	sdkfjf
suddenly	sjdddjlj
discover	dksdlfdf
candidate	dajdkdafd
production	;fldjdfklj
treat	ffdaf
trip	ffk;
evening	dfdjkjf
affect	affddf
inside	kjskdd
conference	dljfdfdjdd
unit	jjkf
style	sfjld
adult	adjlf
worry	slffj
range	fajfd
mention	jdjfklj
deep	ddd;
edge	ddfd
specific	s;ddkfkd
writer	sfkfdf
trouble	ffljfld
necessary	jdddssafj
throughout	fjfljfjljf
challenge	djalldjfd
fear	fdaf
shoulder	sjljlddf
institution	kjsfkfjfklj
middle	jkddld
sea	sda
dream	dfdaj
bar	faf
beautiful	fdajfkfjl
property	;fl;dffj
instead	kjsfdad
improve	kj;flfd
stuff	sfjff
detail	ddfakl
method	jdfjld
somebody	sljdfldj
magazine	jafaakjd
hotel	jlfdl
soldier	slldkdf
reflect	fdflddf
heavy	jdafj
sexual	sdsjal
bag	faf
heat	jdaf
marriage	jaffkafd
tough	fljfj
sing	skjf
surface	sjffadd
purpose	;jf;lsd
exist	dsksf
pattern	;affdfj
whom	sjlj
skin	skkj
agent	afdjf
owner	lsjdf
machine	jadjkjd
gas	fas
ahead	ajdad
generation	fdjdfafklj
commercial	dljjdfdkal
address	addfdss
cancer	dajddf
item	kfdj
reality	fdalkfj
coach	dladj
mrs	jfs
yard	jafd
beat	fdaf
violence	fklldjdd
total	flfal
tend	fdjd
investment	kjfdsfjdjf
discussion	dksdjssklj
finger	fkjfdf
garden	fafddj
notice	jlfkdd
collection	dlllddfklj
modern	jlddfj
task	fask
partner	;affjdf
positive	;lskfkfd
civil	dkfkl
kitchen	kkfdjdj
consumer	dljsjjdf
shot	sjlf
budget	fjdfdf
wish	sksj
painting	;akjfkjf
scientist	sdkdjfksf
safe	safd
agreement	affddjdjf
capital	da;kfal
mouth	jljfj
nor	jlf
victim	fkdfkj
newspaper	jdss;a;df
threat	fjfdaf
responsibility	fds;ljskfklkfj
smile	sjkld
attorney	afflfjdj
score	sdlfd
account	addljjf
interesting	kjfdfdsfkjf
audience	ajdkdjdd
rich	fkdj
dinner	dkjjdf
vote	flfd
western	sdsfdfj
relate	fdlafd
travel	ffafdl
debate	ddfafd
prevent	;fdfdjf
citizen	dkfkadj
majority	jajlfkfj
none	jljd
front	ffljf
born	flfj
admit	adjkf
senior	sdjklf
assume	assjjd
wind	skjd
key	kdj
professional	;flfdsskljal
mission	jkssklj
fast	fasf
alone	alljd
customer	djsfljdf
suffer	sjffdf
speech	s;dddj
successful	sjdddssfjl
option	l;fklj
participant	;affkdk;ajf
southern	sljfjdfj
fresh	ffdsj
eventually	dfdjfjallj
forest	flfdsf
video	fkddl
global	fllfal
senate	sdjafd
reform	fdflfj
access	adddss
restaurant	fdsfajfajf
judge	jjdfd
publish	;jflksj
relation	fdlafklj
release	fdldasd
bird	fkfd
opinion	l;kjklj
credit	dfddkf
critical	dfkfkdal
corner	dlfjdf
concerned	dljddfjdd
recall	fddall
version	fdfsklj
stare	sfafd
safety	safdfj
effective	dffddfkfd
neighborhood	jdkfjflfjlld
original	lfkfkjal
troop	ffll;
income	kjdljd
directly	dkfddflj
hurt	jjff
species	s;ddkds
immediately	kjjddkafdlj
track	ffadk
basic	faskd
strike	sffkkd
sky	skj
freedom	ffdddlj
absolutely	afslljfdlj
plane	;lajd
nobody	jlfldj
achieve	adjkdfd
object	lfjddf
attitude	affkfjdd
labor	laflf
refer	fdfdf
concept	dljdd;f
client	dlkdjf
powerful	;lsdffjl
perfect	;dffddf
nine	jkjd
therefore	fjdfdflfd
conduct	dljdjdf
announce	ajjljjdd
conversation	dljfdfsafklj
examine	dsajkjd
touch	fljdj
please	;ldasd
attend	affdjd
completely	dlj;ldfdlj
variety	fafkdfj
sleep	sldd;
involved	kjfllfdd
investigation	kjfdsfkfafklj
nuclear	jjdldaf
researcher	fdsdafdjdf
press	;fdss
conflict	dljflkdf
spirit	s;kfkf
replace	fd;ladd
british	ffkfksj
encourage	djdljfafd
argument	affjjdjf
camp	daj;
brain	ffakj
feature	fdafjfd
afternoon	affdfjllj
am	aj
weekend	sddkdjd
dozen	dladj
possibility	;lsskfklkfj
insurance	kjsjfajdd
department	dd;affjdjf
battle	faffld
beginning	fdfkjjkjf
date	dafd
generally	fdjdfallj
african	affkdaj
sorry	slffj
crisis	dfksks
complete	dlj;ldfd
fan	faj
stick	sfkdk
define	ddfkjd
easily	dasklj
hole	jlld
element	dldjdjf
vision	fksklj
status	sfafjs
normal	jlfjal
chinese	djkjdsd
ship	sjk;
solution	slljfklj
stone	sfljd
slowly	sllslj
scale	sdald
university	jjkfdfskfj
introduce	kjffldjdd
driver	dfkfdf
attempt	affdj;f
park	;afk
spot	s;lf
lack	ladk
ice	kdd
boat	flaf
drink	dfkjk
sun	sjj
distance	dksfajdd
wood	slld
handle	jajdld
truck	ffjdk
mountain	jljjfakj
survey	sjffdj
supposed	sj;;lsdd
tradition	ffadkfklj
winter	skjfdf
village	fkllafd
soviet	slfkdf
refuse	fdfjsd
sales	salds
roll	flll
communication	dljjjjkdafklj
screen	sdfddj
gain	fakj
resident	fdskddjf
hide	jkdd
gold	flld
club	dljf
farm	fafj
potential	;lfdjfkal
european	djfl;daj
presence	;fdsdjdd
independent	kjdd;djddjf
district	dksffkdf
shape	sja;d
reader	fdaddf
ms	js
contract	dljffadf
crowd	dflsd
christian	djfksfkaj
express	ds;fdss
apartment	a;affjdjf
willing	skllkjf
strength	sffdjffj
previous	;fdfkljs
band	fajd
obviously	lffkljslj
horse	jlfsd
interested	kjfdfdsfdd
target	faffdf
prison	;fkslj
ride	fkdd
guard	fjafd
terms	fdfjs
demand	ddjajd
reporter	fd;lffdf
deliver	ddlkfdf
text	fdsf
tool	flll
wild	skld
vehicle	fdjkdld
observe	lfsdffd
flight	flkfjf
facility	fadklkfj
understanding	jjddfsfajdkjf
average	afdfafd
emerge	djdffd
advantage	adfajfafd
quick	ajkdk
leadership	ldaddfsjk;
earn	dafj
pound	;ljjd
basis	fasks
bright	ffkfjf
operate	l;dfafd
guest	fjdsf
sample	saj;ld
contribute	dljffkfjfd
tiny	fkjj
block	flldk
protection	;flfddfklj
settle	sdffld
feed	fddd
collect	dlllddf
additional	addkfkljal
highly	jkfjlj
identity	kddjfkfj
title	fkfld
mostly	jlsflj
lesson	ldsslj
faith	fakfj
river	fkfdf
promote	;fljlfd
living	lkfkjf
count	dljjf
unless	jjldss
marry	jaffj
tomorrow	fljlffls
technique	fddjjkajd
path	;afj
ear	daf
shop	sjl;
folk	fllk
principle	;fkjdk;ld
survive	sjffkfd
lift	lkff
border	flfddf
competition	dlj;dfkfklj
jump	jjj;
gather	fafjdf
limit	lkjkf
fit	fkf
cry	dfj
equipment	dajk;jdjf
worth	slffj
associate	assldkafd
critic	dfkfkd
warm	safj
aspect	as;ddf
insist	kjsksf
failure	fakljfd
annual	ajjjal
french	ffdjdj
christmas	djfksfjas
comment	dljjdjf
responsible	fds;ljskfld
affair	affakf
procedure	;fldddjfd
regular	fdfjlaf
spread	s;fdad
chairman	djakfjaj
baseball	fasdfall
soft	slff
ignore	kfjlfd
egg	dff
belief	fdlkdf
demonstrate	ddjljsffafd
anybody	ajjfldj
murder	jjfddf
gift	fkff
religion	fdlkfklj
review	fdfkds
editor	ddkflf
engage	djfafd
coffee	dlffdd
document	dldjjdjf
speed	s;ddd
cross	dflss
influence	kjfljdjdd
anyway	ajjsaj
threaten	fjfdafdj
commit	dljjkf
female	fdjald
youth	jljfj
wave	safd
afraid	affakd
quarter	ajaffdf
background	fadkffljjd
native	jafkfd
broad	fflad
wonderful	sljddffjl
deny	ddjj
apparently	a;;afdjflj
slightly	slkfjflj
reaction	fdadfklj
twice	fskdd
suit	sjkf
perspective	;dfs;ddfkfd
growing	fflskjf
blow	flls
construction	dljsffjdfklj
intelligence	kjfdllkfdjdd
destroy	ddsfflj
cook	dllk
connection	dljjddfklj
burn	fjfj
shoe	sjld
grade	ffadd
context	dljfdsf
committee	dljjkffdd
hey	jdj
mistake	jksfakd
location	lldafklj
clothes	dllfjds
indian	kjdkaj
quiet	ajkdf
dress	dfdss
promise	;fljksd
aware	asafd
neighbor	jdkfjflf
function	fjjdfklj
bone	fljd
active	adfkfd
extend	dsfdjd
chief	djkdf
combine	dljfkjd
wine	skjd
below	fdlls
cool	dlll
voter	flfdf
learning	ldafjkjf
bus	fjs
hell	jdll
dangerous	dajfdfljs
remind	fdjkjd
moral	jlfal
united	jjkfdd
category	dafdflfj
relatively	fdlafkfdlj
victory	fkdflfj
academic	adaddjkd
internet	kjfdfjdf
healthy	jdalfjj
negative	jdfafkfd
following	fllllskjf
historical	jksflfkdal
medicine	jddkdkjd
tour	fljf
depend	dd;djd
photo	;jlfl
finding	fkjdkjf
grab	ffaf
direct	dkfddf
classroom	dlassfllj
contact	dljfadf
justice	jjsfkdd
participate	;affkdk;afd
daily	daklj
fair	fakf
pair	;akf
famous	fajljs
exercise	dsdfdksd
knee	kjdd
flower	fllsdf
tape	fa;d
hire	jkfd
familiar	fajklkaf
appropriate	a;;fl;fkafd
supply	sj;;lj
fully	fjllj
actor	adflf
birth	fkffj
search	sdafdj
tie	fkd
democracy	ddjldfadj
eastern	dasfdfj
primary	;fkjafj
yesterday	jdsfdfdaj
circle	dkfdld
device	ddfkdd
progress	;flffdss
bottom	flfflj
island	kslajd
exchange	dsdjajfd
clean	dldaj
studio	sfjdkl
train	ffakj
lady	ladj
colleague	dllldafjd
application	a;;lkdafklj
neck	jddk
lean	ldaj
damage	dajafd
plastic	;lasfkd
tall	fall
plate	;lafd
hate	jafd
otherwise	lfjdfsksd
writing	sfkfkjf
male	jald
alive	alkfd
expression	ds;fdssklj
football	fllffall
intend	kjfdjd
chicken	djkdkdj
army	afjj
abuse	afjsd
theater	fjdafdf
shut	sjjf
map	ja;
extra	dsffa
session	sdssklj
danger	dajfdf
welcome	sdldljd
domestic	dljdsfkd
lots	llfs
literature	lkfdfafjfd
rain	fakj
desire	ddskfd
assessment	assdssjdjf
injury	kjjjfj
respect	fds;ddf
northern	jlffjdfj
nod	jld
paint	;akjf
fuel	fjdl
leaf	ldaf
dry	dfj
russian	fjsskaj
instruction	kjsffjdfklj
pool	;lll
climb	dlkjf
sweet	ssddf
engine	djfkjd
fourth	fljffj
salt	salf
expand	ds;ajd
importance	kj;lffajdd
metal	jdfal
fat	faf
ticket	fkdkdf
software	slffsafd
disappear	dksa;;daf
corporate	dlf;lfafd
strange	sffajfd
lip	lk;
reading	fdadkjf
urban	jffaj
mental	jdjfal
increasingly	kjdfdaskjflj
lunch	ljjdj
educational	ddjdafkljal
somewhere	sljdsjdfd
farmer	fafjdf
sugar	sjfaf
planet	;lajdf
favorite	faflfkfd
explore	ds;llfd
obtain	lffakj
enemy	djdjj
greatest	ffdafdsf
complex	dlj;lds
surround	sjffljjd
athlete	afjldfd
invite	kjfkfd
repeat	fd;daf
carefully	dafdfjllj
soul	sljl
scientific	sdkdjfkfkd
impossible	kj;lsskfld
panel	;ajdl
meaning	jdajkjf
mom	jlj
married	jaffkdd
instrument	kjsffjjdjf
predict	;fddkdf
weather	sdafjdf
presidential	;fdskddjfkal
emotional	djlfkljal
commitment	dljjkfjdjf
supreme	sj;fdjd
bear	fdaf
pocket	;ldkdf
thin	fjkj
temperature	fdj;dfafjfd
surprise	sjf;fksd
poll	;lll
proposal	;fl;lsal
consequence	dljsdajdjdd
breath	ffdafj
sight	skfjf
balance	falajdd
adopt	adl;f
minority	jkjlfkfj
straight	sffakfjf
connect	dljjddf
works	slfks
teaching	fdadjkjf
belong	fdlljf
aid	akd
advice	adfkdd
okay	lkaj
photograph	;jlflffa;j
empty	dj;fj
regional	fdfkljal
trail	ffakl
novel	jlfdl
code	dldd
somehow	sljdjls
organize	lffajkad
jury	jjfj
breast	ffdasf
iraqi	kfaak
acknowledge	adkjlslddfd
theme	fjdjd
storm	sflfj
union	jjklj
desk	ddsk
thanks	fjajks
fruit	ffjkf
expensive	ds;djskfd
yellow	jdllls
conclusion	dljdljsklj
prime	;fkjd
shadow	sjadls
struggle	sffjffld
conclude	dljdljdd
analyst	ajaljsf
dance	dajdd
regulation	fdfjlafklj
being	fdkjf
ring	fkjf
largely	laffdlj
shift	sjkff
revenue	fdfdjjd
mark	jafk
locate	lldafd
county	dljjfj
appearance	a;;dafajdd
package	;adkafd
difficulty	dkffkdjlfj
bridge	ffkdfd
recommend	fddljjdjd
obvious	lffkljs
basically	faskdallj
e-mail	d;jakl
generate	fdjdfafd
anymore	ajjjlfd
propose	;fl;lsd
thinking	fjkjkkjf
possibly	;lsskflj
trend	ffdjd
visitor	fkskflf
loan	llaj
currently	djffdjflj
comfortable	dljflffafld
investor	kjfdsflf
profit	;flfkf
angry	ajffj
crew	dfds
accident	addkddjf
meal	jdal
hearing	jdafkjf
traffic	ffaffkd
muscle	jjsdld
notion	jlfklj
capture	da;fjfd
prefer	;fdfdf
truly	ffjlj
earth	daffj
japanese	ja;ajdsd
chest	djdsf
thick	fjkdk
cash	dasj
museum	jjsdjj
beauty	fdajfj
emergency	djdffdjdj
unique	jjkajd
internal	kjfdfjal
ethnic	dfjjkd
link	lkjk
stress	sffdss
content	dljfdjf
select	sdlddf
root	fllf
nose	jlsd
declare	dddlafd
appreciate	a;;fddkafd
actual	adfjal
bottle	flffld
hardly	jafdlj
setting	sdffkjf
launch	lajjdj
file	fkld
sick	skdk
outcome	ljfdljd
ad	ad
defend	ddfdjd
duty	djfj
sheet	sjddf
ought	ljfjf
ensure	djsjfd
catholic	dafjllkd
extremely	dsffdjdlj
extent	dsfdjf
component	dlj;ljdjf
mix	jks
long-term	lljf;fdfj
slow	slls
contrast	dljffasf
zone	aljd
wake	sakd
airport	akf;lff
brown	fflsj
shirt	sjkff
pilot	;kllf
warn	safj
ultimately	jlfkjafdlj
cat	daf
contribution	dljffkfjfklj
capacity	da;adkfj
ourselves	ljfsdlfds
estate	dsfafd
guide	fjkdd
circumstance	dkfdjjsfajdd
snow	sjls
english	djflksj
politician	;llkfkdkaj
steal	sfdal
pursue	;jfsjd
slip	slk;
percentage	;dfddjfafd
meat	jdaf
funny	fjjjj
neither	jdkfjdf
soil	slkl
surgery	sjffdfj
correct	dlffddf
jewish	jdsksj
blame	flajd
estimate	dsfkjafd
due	djd
basketball	faskdffall
golf	fllf
investigate	kjfdsfkfafd
crazy	dfaaj
significantly	skfjkfkdajflj
chain	djakj
branch	ffajdj
combination	dljfkjafklj
frequently	ffdajdjflj
governor	flfdfjlf
relief	fdlkdf
user	jsdf
dad	dad
kick	kkdk
manner	jajjdf
ancient	ajdkdjf
silence	skldjdd
rating	fafkjf
golden	fllddj
motion	jlfklj
german	fdfjaj
gender	fdjddf
solve	sllfd
fee	fdd
landscape	lajdsda;d
used	jsdd
bowl	flsl
equal	dajal
forth	flffj
frame	ffajd
typical	fj;kdal
except	dsdd;f
conservative	dljsdffafkfd
eliminate	dlkjkjafd
host	jlsf
hall	jall
trust	ffjsf
ocean	lddaj
row	fls
producer	;fldjddf
afford	afflfd
meanwhile	jdajsjkld
regime	fdfkjd
division	dkfksklj
confirm	dljfkfj
fix	fks
appeal	a;;dal
mirror	jkfflf
tooth	fllfj
smart	sjaff
length	ldjffj
entirely	djfkfdlj
rely	fdlj
topic	fl;kd
complain	dlj;lakj
variable	fafkafld
telephone	fdld;jljd
perception	;dfdd;fklj
attract	afffadf
confidence	dljfkddjdd
bedroom	fddfllj
secret	sddfdf
debt	ddff
rare	fafd
tank	fajk
nurse	jjfsd
coverage	dlfdfafd
opposition	l;;lskfklj
aside	askdd
anywhere	ajjsjdfd
bond	fljd
pleasure	;ldasjfd
master	jasfdf
era	dfa
requirement	fdajkfdjdjf
fun	fjj
expectation	ds;ddfafklj
wing	skjf
separate	sd;afafd
somewhat	sljdsjaf
pour	;ljf
stir	sfkf
judgment	jjdfjdjf
beer	fddf
reference	fdfdfdjdd
tear	fdaf
doubt	dljff
grant	ffajf
seriously	sdfkljslj
minister	jkjksfdf
totally	flfallj
hero	jdfl
industrial	kjdjsffkal
cloud	dlljd
stretch	sffdfdj
winner	skjjdf
volume	flljjd
seed	sddd
surprised	sjf;fksdd
fashion	fasjklj
pepper	;d;;df
busy	fjsj
intervention	kjfdffdjfklj
copy	dl;j
tip	fk;
cheap	djda;
aim	akj
cite	dkfd
welfare	sdlfafd
vegetable	fdfdfafld
gray	ffaj
dish	dksj
beach	fdadj
improvement	kj;flfdjdjf
everywhere	dfdfjsjdfd
opening	l;djkjf
overall	lfdfall
divide	dkfkdd
initial	kjkfkal
terrible	fdffkfld
oppose	l;;lsd
contemporary	dljfdj;lfafj
route	fljfd
multiple	jjlfk;ld
essential	dssdjfkal
league	ldafjd
criminal	dfkjkjal
careful	dafdfjl
core	dlfd
upper	j;;df
rush	fjsj
necessarily	jdddssafklj
specifically	s;ddkfkdallj
tired	fkfdd
employ	dj;llj
holiday	jllkdaj
vast	fasf
resolution	fdslljfklj
household	jljsdjlld
fewer	fdsdf
abortion	aflffklj
apart	a;aff
witness	skfjdss
match	jafdj
barely	fafdlj
sector	sddflf
representative	fd;fdsdjfafkfd
beneath	fdjdafj
beside	fdskdd
incident	kjdkddjf
limited	lkjkfdd
proud	;fljd
flow	flls
faculty	fadjlfj
increased	kjdfdasdd
waste	sasfd
merely	jdfdlj
mass	jass
emphasize	dj;jaskad
experiment	ds;dfkjdjf
definitely	ddfkjkfdlj
bomb	fljf
enormous	djlfjljs
tone	fljd
liberal	lkfdfal
massive	jasskfd
engineer	djfkjddf
wheel	sjddl
decline	dddlkjd
invest	kjfdsf
cable	dafld
towards	flsafds
expose	ds;lsd
rural	fjfal
aids	akds
jew	jds
narrow	jaffls
cream	dfdaj
secretary	sddfdfafj
gate	fafd
solid	sllkd
hill	jkll
typically	fj;kdallj
noise	jlksd
grass	ffass
unfortunately	jjflffjjafdlj
hat	jaf
legislation	ldfkslafklj
succeed	sjddddd
celebrate	ddldffafd
achievement	adjkdfdjdjf
fishing	fksjkjf
accuse	addjsd
useful	jsdfjl
reject	fdjddf
talent	faldjf
taste	fasfd
characteristic	djafadfdfksfkd
milk	jklk
escape	dsda;d
cast	dasf
sentence	sdjfdjdd
unusual	jjjsjal
closely	dllsdlj
convince	dljfkjdd
height	jdkfjf
physician	;jjskdkaj
assess	assdss
plenty	;ldjfj
virtually	fkffjallj
addition	addkfklj
sharp	sjaf;
creative	dfdafkfd
lower	llsdf
approve	a;;flfd
explanation	ds;lajafklj
gay	faj
campus	daj;js
proper	;fl;df
guilty	fjklfj
acquire	adajkfd
compete	dlj;dfd
technical	fddjjkdal
plus	;ljs
immigrant	kjjkffajf
weak	sdak
illegal	klldfal
hi	jk
alternative	alfdfjafkfd
interaction	kjfdfadfklj
column	dlljjj
personality	;dfsljalkfj
signal	skfjal
curriculum	djffkdjljj
honor	jljlf
passenger	;assdjfdf
assistance	assksfajdd
forever	flfdfdf
regard	fdfafd
israeli	ksfadlk
association	assldkafklj
twenty	fsdjfj
knock	kjldk
wrap	sfa;
lab	laf
display	dks;laj
criticism	dfkfkdksj
asset	assdf
depression	dd;fdssklj
spiritual	s;kfkfjal
musical	jjskdal
journalist	jljfjalksf
prayer	;fajdf
suspect	sjs;ddf
scholar	sdjllaf
warning	safjkjf
climate	dlkjafd
cheese	djddsd
observation	lfsdffafklj
childhood	djkldjlld
payment	;ajjdjf
sir	skf
permit	;dfjkf
cigarette	dkfafdffd
definition	ddfkjkfklj
priority	;fklfkfj
bread	ffdad
creation	dfdafklj
graduate	ffadjafd
request	fdajdsf
emotion	djlfklj
scream	sdfdaj
dramatic	dfajafkd
universe	jjkfdfsd
gap	fa;
excellent	dsddlldjf
deeply	ddd;lj
prosecutor	;flsddjflf
lucky	ljdkj
drag	dfaf
airline	akflkjd
library	lkffafj
agenda	afdjda
recover	fddlfdf
factory	fadflfj
selection	sdlddfklj
primarily	;fkjafklj
roof	fllf
unable	jjafld
expense	ds;djsd
initiative	kjkfkafkfd
diet	dkdf
arrest	affdsf
funding	fjjdkjf
therapy	fjdfa;j
wash	sasj
schedule	sdjddjld
sad	sad
brief	ffkdf
housing	jljskjf
post	;lsf
purchase	;jfdjasd
existing	dsksfkjf
steel	sfddl
regarding	fdfafdkjf
shout	sjljf
remaining	fdjakjkjf
visual	fksjal
fairly	fakflj
chip	djk;
violent	fklldjf
silent	skldjf
suppose	sj;;lsd
self	sdlf
bike	fkkd
tea	fda
perceive	;dfddkfd
comparison	dlj;afkslj
settlement	sdffldjdjf
layer	lajdf
planning	;lajjkjf
description	ddsdfk;fklj
slide	slkdd
widely	skddlj
wedding	sdddkjf
inform	kjflfj
portion	;lffklj
territory	fdffkflfj
immediate	kjjddkafd
opponent	l;;ljdjf
abandon	afajdlj
lake	lakd
transform	ffajsflfj
tension	fdjsklj
leading	ldadkjf
bother	flfjdf
consist	dljsksf
alcohol	aldljll
enable	djafld
bend	fdjd
saving	safkjf
desert	ddsdff
shall	sjall
error	dfflf
cop	dl;
arab	afaf
double	dljfld
sand	sajd
spanish	s;ajksj
print	;fkjf
preserve	;fdsdffd
passage	;assafd
formal	flfjal
transition	ffajskfklj
existence	dsksfdjdd
album	alfjj
participation	;affkdk;afklj
arrange	affajfd
atmosphere	afjls;jdfd
joint	jlkjf
reply	fd;lj
cycle	djdld
opposite	l;;lskfd
lock	lldk
deserve	ddsdffd
consistent	dljsksfdjf
resistance	fdsksfajdd
discovery	dksdlfdfj
exposure	ds;lsjfd
pose	;lsd
stream	sffdaj
sale	sald
pot	;lf
grand	ffajd
mine	jkjd
hello	jdlll
coalition	dlalkfklj
tale	fald
knife	kjkfd
resolve	fdsllfd
racial	fadkal
phase	;jasd
joke	jlkd
coat	dlaf
mexican	jdskdaj
symptom	sjj;flj
manufacturer	jajjfadfjfdf
philosophy	;jkllsl;jj
potato	;lfafl
foundation	fljjdafklj
quote	ajlfd
online	ljlkjd
negotiation	jdflfkafklj
urge	jffd
occasion	lddasklj
dust	djsf
breathe	ffdafjd
elect	dlddf
investigator	kjfdsfkfaflf
jacket	jadkdf
glad	flad
ordinary	lfdkjafj
reduction	fddjdfklj
rarely	fafdlj
pack	;adk
suicide	sjkdkdd
numerous	jjjdfljs
substance	sjfsfajdd
discipline	dksdk;lkjd
elsewhere	dlsdsjdfd
iron	kflj
practical	;fadfkdal
moreover	jlfdlfdf
passion	;assklj
volunteer	flljjfddf
implement	kj;ldjdjf
essentially	dssdjfkallj
gene	fdjd
enforcement	djflfddjdjf
vs	fs
sauce	sajdd
independence	kjdd;djddjdd
marketing	jafkdfkjf
priest	;fkdsf
amazing	ajaakjf
intense	kjfdjsd
advance	adfajdd
employer	dj;lljdf
shock	sjldk
inspire	kjs;kfd
adjust	adjjsf
retire	fdfkfd
visible	fkskfld
kiss	kkss
illness	klljdss
cap	da;
habit	jafkf
competitive	dlj;dfkfkfd
juice	jjkdd
congressional	dljffdsskljal
involvement	kjfllfdjdjf
dominate	dljkjafd
previously	;fdfkljslj
whenever	sjdjdfdf
transfer	ffajsfdf
analyze	ajaljad
attach	affadj
disaster	dksasfdf
parking	;afkkjf
prospect	;fls;ddf
boss	flss
complaint	dlj;lakjf
championship	djaj;kljsjk;
fundamental	fjjdajdjfal
severe	sdfdfd
enhance	djjajdd
mystery	jjsfdfj
impose	kj;lsd
poverty	;lfdffj
entry	djffj
spending	s;djdkjf
king	kkjf
evaluate	dfaljafd
symbol	sjjfll
maker	jakdf
mood	jlld
accomplish	addlj;lksj
emphasis	dj;jasks
illustrate	klljsffafd
boot	fllf
monitor	jljkflf
asian	askaj
entertainment	djfdffakjjdjf
bean	fdaj
evaluation	dfaljafklj
creature	dfdafjfd
commander	dljjajddf
digital	dkfkfal
arrangement	affajfdjdjf
concentrate	dljddjffafd
usual	jsjal
anger	ajfdf
psychological	;sjdjlllfkdal
heavily	jdafklj
peak	;dak
approximately	a;;flskjafdlj
increasing	kjdfdaskjf
disorder	dkslfddf
missile	jksskld
equally	dajallj
vary	fafj
wire	skfd
round	fljjd
distribution	dksffkfjfklj
transportation	ffajs;lffafklj
holy	jllj
twin	fskj
command	dljjajd
commission	dljjkssklj
interpretation	kjfdf;fdfafklj
breakfast	ffdakfasf
strongly	sffljflj
engineering	djfkjddfkjf
luck	ljdk
so-called	sl;dalldd
constant	dljsfajf
clinic	dlkjkd
veteran	fdfdfaj
smell	sjdll
tablespoon	faflds;llj
capable	da;afld
nervous	jdffljs
tourist	fljfksf
toss	flss
crucial	dfjdkal
bury	fjfj
pray	;faj
tomato	fljafl
exception	dsdd;fklj
butter	fjffdf
deficit	ddfkdkf
bathroom	fafjfllj
objective	lfjddfkfd
electronic	dlddffljkd
ally	allj
journey	jljfjdj
reputation	fd;jfafklj
mixture	jksfjfd
surely	sjfdlj
tower	flsdf
smoke	sjlkd
confront	dljffljf
pure	;jfd
glance	flajdd
dimension	dkjdjsklj
toy	flj
prisoner	;fksljdf
fellow	fdllls
smooth	sjllfj
nearby	jdaffj
peer	;ddf
designer	ddskfjdf
personnel	;dfsljjdl
educator	ddjdaflf
relative	fdlafkfd
immigration	kjjkffafklj
belt	fdlf
teaspoon	fdas;llj
birthday	fkffjdaj
implication	kj;lkdafklj
perfectly	;dffddflj
coast	dlasf
supporter	sj;;lffdf
accompany	addlj;ajj
silver	sklfdf
teenager	fddjafdf
recognition	fddlfjkfklj
retirement	fdfkfdjdjf
flag	flaf
recovery	fddlfdfj
whisper	sjks;df
gentleman	fdjfldjaj
corn	dlfj
moon	jllj
inner	kjjdf
junior	jjjklf
throat	fjflaf
salary	salafj
swing	sskjf
observer	lfsdffdf
publication	;jflkdafklj
crop	dfl;
dig	dkf
permanent	;dfjajdjf
phenomenon	;jdjljdjlj
anxiety	ajskdfj
unlike	jjlkkd
wet	sdf
literally	lkfdfallj
resist	fdsksf
convention	dljfdjfklj
embrace	djffadd
assist	assksf
exhibition	dsjkfkfklj
construct	dljsffjdf
viewer	fkdsdf
pan	;aj
consultant	dljsjlfajf
administrator	adjkjksffaflf
occasionally	lddaskljallj
mayor	jajlf
consideration	dljskddfafklj
ceo	ddl
secure	sddjfd
pink	;kjk
buck	fjdk
historic	jksflfkd
poem	;ldj
grandmother	ffajdjlfjdf
bind	fkjd
fifth	fkffj
constantly	dljsfajflj
enterprise	djfdf;fksd
favor	faflf
testing	fdsfkjf
stomach	sfljadj
apparent	a;;afdjf
weigh	sdkfj
install	kjsfall
sensitive	sdjskfkfd
suggestion	sjffdsfklj
mail	jakl
recipe	fddk;d
reasonable	fdasljafld
preparation	;fd;afafklj
wooden	sllddj
elementary	dldjdjfafj
concert	dljddff
aggressive	afffdsskfd
false	falsd
intention	kjfdjfklj
channel	djajjdl
extreme	dsffdjd
tube	fjfd
drawing	dfaskjf
protein	;flfdkj
quit	ajkf
absence	afsdjdd
latin	lafkj
rapidly	fa;kdlj
jail	jakl
diversity	dkfdfskfj
honest	jljdsf
palestinian	;aldsfkjkaj
pace	;add
employment	dj;lljjdjf
speaker	s;dakdf
impression	kj;fdssklj
essay	dssaj
respondent	fds;ljddjf
giant	fkajf
cake	dakd
historian	jksflfkaj
negotiate	jdflfkafd
restore	fdsflfd
substantial	sjfsfajfkal
pop	;l;
specialist	s;ddkalksf
origin	lfkfkj
approval	a;;flfal
quietly	ajkdflj
advise	adfksd
conventional	dljfdjfkljal
depth	dd;fj
wealth	sdalfj
disability	dksafklkfj
shell	sjdll
criticize	dfkfkdkad
effectively	dffddfkfdlj
biological	fklllfkdal
onion	ljklj
deputy	dd;jfj
flat	flaf
brand	ffajd
assure	assjfd
mad	jad
award	asafd
criteria	dfkfdfka
dealer	ddaldf
via	fka
utility	jfklkfj
precisely	;fddksdlj
arise	afksd
armed	afjdd
nevertheless	jdfdffjdldss
highway	jkfjsaj
clinical	dlkjkdal
routine	fljfkjd
wage	safd
normally	jlfjallj
phrase	;jfasd
ingredient	kjffddkdjf
stake	sfakd
muslim	jjslkj
fiber	fkfdf
activist	adfkfksf
islamic	kslajkd
snap	sja;
terrorism	fdfflfksj
refugee	fdfjfdd
incorporate	kjdlf;lfafd
hip	jk;
ultimate	jlfkjafd
switch	sskfdj
corporation	dlf;lfafklj
valuable	faljafld
assumption	assjj;fklj
gear	fdaf
barrier	faffkdf
minor	jkjlf
provision	;flfksklj
killer	kklldf
assign	asskfj
gang	fajf
developing	ddfdll;kjf
classic	dlasskd
chemical	djdjkdal
label	lafdl
teen	fddj
index	kjdds
vacation	fadafklj
advocate	adfldafd
draft	dfaff
extraordinary	dsffalfdkjafj
heaven	jdafdj
rough	fljfj
yell	jdll
pregnant	;fdfjajf
distant	dksfajf
drama	dfaja
satellite	safdllkfd
personally	;dfsljallj
clock	dlldk
chocolate	djldllafd
italian	kfalkaj
canadian	dajadkaj
ceiling	ddklkjf
sweep	ssdd;
advertising	adfdffkskjf
universal	jjkfdfsal
spin	s;kj
button	fjfflj
bell	fdll
rank	fajk
darkness	dafkjdss
clothing	dllfjkjf
super	sj;df
yield	jkdld
fence	fdjdd
portrait	;lfffakf
survival	sjffkfal
roughly	fljfjlj
lawsuit	lassjkf
testimony	fdsfkjljj
bunch	fjjdj
found	fljjd
burden	fjfddj
react	fdadf
chamber	djajfdf
furniture	fjfjkfjfd
cooperation	dll;dfafklj
string	sffkjf
ceremony	ddfdjljj
communicate	dljjjjkdafd
cheek	djddk
lost	llsf
profile	;flfkld
mechanism	jddjajksj
disagree	dksaffdd
penalty	;djalfj
ie	kd
resort	fdslff
destruction	ddsffjdfklj
unlikely	jjlkkdlj
tissue	fkssjd
constitutional	dljsfkfjfkljal
pant	;ajf
stranger	sffajfdf
infection	kjfddfklj
cabinet	dafkjdf
broken	fflkdj
apple	a;;ld
electric	dlddffkd
proceed	;fldddd
bet	fdf
literary	lkfdfafj
virus	fkfjs
stupid	sfj;kd
dispute	dks;jfd
fortune	flffjjd
strategic	sffafdfkd
assistant	assksfajf
overcome	lfdfdljd
remarkable	fdjafkafld
occupy	lddj;j
statistics	sfafksfkds
shopping	sjl;;kjf
cousin	dljskj
encounter	djdljjfdf
wipe	sk;d
initially	kjkfkallj
blind	flkjd
port	;lff
electricity	dlddffkdkfj
genetic	fdjdfkd
adviser	adfksdf
spokesman	s;lkdsjaj
retain	fdfakj
latter	laffdf
incentive	kjddjfkfd
slave	slafd
translate	ffajslafd
accurate	addjfafd
whereas	sjdfdas
terror	fdfflf
expansion	ds;ajsklj
elite	dlkfd
olympic	lljj;kd
dirt	dkff
odd	ldd
rice	fkdd
bullet	fjlldf
tight	fkfjf
bible	fkfld
chart	djaff
solar	sllaf
square	sajafd
concentration	dljddjffafklj
complicated	dlj;lkdafdd
gently	fdjflj
champion	djaj;klj
scenario	sddjafkl
telescope	fdldsdl;d
reflection	fdflddfklj
revolution	fdflljfklj
strip	sffk;
interpret	kjfdf;fdf
friendly	ffkdjdlj
tournament	fljfjajdjf
fiction	fkdfklj
detect	ddfddf
tremendous	ffdjdjdljs
lifetime	lkfdfkjd
recommendation	fddljjdjdafklj
senator	sdjaflf
hunting	jjjfkjf
salad	salad
guarantee	fjafajfdd
innocent	kjjlddjf
boundary	fljjdafj
pause	;ajsd
remote	fdjlfd
satisfaction	safksfadfklj
journal	jljfjal
bench	fdjdj
lover	llfdf
raw	fas
awareness	asafdjdss
surprising	sjf;fkskjf
withdraw	skfjdfas
deck	dddk
similarly	skjklaflj
newly	jdslj
pole	;lld
testify	fdsfkfj
mode	jldd
dialogue	dkallfjd
imply	kj;lj
naturally	jafjfallj
mutual	jjfjal
founder	fljjddf
advanced	adfajddd
pride	;fkdd
dismiss	dksjkss
aircraft	akfdfaff
delivery	ddlkfdfj
mainly	jakjlj
bake	fakd
freeze	ffddad
platform	;lafflfj
finance	fkjajdd
sink	skjk
attractive	afffadfkfd
diverse	dkfdfsd
relevant	fdldfajf
ideal	kddal
joy	jlj
regularly	fdfjlaflj
working	slfkkjf
singer	skjfdf
evolve	dfllfd
shooting	sjllfkjf
partly	;afflj
unknown	jjkjlsj
offense	lffdjsd
counter	dljjfdf
dna	dja
potentially	;lfdjfkallj
thirty	fjkffj
justify	jjsfkfj
protest	;flfdsf
crash	dfasj
craft	dfaff
treaty	ffdafj
terrorist	fdfflfksf
insight	kjskfjf
possess	;lssdss
politically	;llkfkdallj
tap	fa;
extensive	dsfdjskfd
episode	d;ksldd
swim	sskj
tire	fkfd
fault	fajlf
loose	lllsd
shortly	sjlfflj
originally	lfkfkjallj
considerable	dljskddfafld
prior	;fklf
intellectual	kjfdllddfjal
assault	assajlf
relax	fdlas
stair	sfakf
adventure	adfdjfjfd
external	dsfdfjal
proof	;fllf
confident	dljfkddjf
headquarters	jdadajaffdfs
sudden	sjdddj
dirty	dkffj
violation	fkllafklj
tongue	fljfjd
license	lkddjsd
shelter	sjdlfdf
rub	fjf
controversy	dljfflfdfsj
entrance	djffajdd
properly	;fl;dflj
fade	fadd
defensive	ddfdjskfd
tragedy	ffafddj
net	jdf
characterize	djafadfdfkad
funeral	fjjdfal
profession	;flfdssklj
alter	alfdf
constitute	dljsfkfjfd
establishment	dsfaflksjjdjf
squeeze	sajddad
imagination	kjafkjafklj
mask	jask
convert	dljfdff
comprehensive	dlj;fdjdjskfd
prominent	;fljkjdjf
presentation	;fdsdjfafklj
regardless	fdfafdldss
load	llad
stable	sfafld
introduction	kjffldjdfklj
pretend	;fdfdjd
elderly	dlddflj
representation	fd;fdsdjfafklj
deer	dddf
split	s;lkf
violate	fkllafd
partnership	;affjdfsjk;
pollution	;llljfklj
emission	djkssklj
steady	sfdadj
vital	fkfal
fate	fafd
earnings	dafjkjfs
oven	lfdj
distinction	dksfkjdfklj
segment	sdfjdjf
nowhere	jlsjdfd
poet	;ldf
mere	jdfd
exciting	dsdkfkjf
variation	fafkafklj
comfort	dljflff
radical	fadkdal
adapt	ada;f
irish	kfksj
honey	jljdj
correspondent	dlffds;ljddjf
pale	;ald
musician	jjskdkaj
significance	skfjkfkdajdd
vessel	fdssdl
storage	sflfafd
flee	fldd
mm-hmm	jj;jjj
leather	ldafjdf
distribute	dksffkfjfd
evolution	dflljfklj
ill	kll
tribe	ffkfd
shelf	sjdlf
grandfather	ffajdfafjdf
lawn	lasj
buyer	fjjdf
dining	dkjkjf
wisdom	sksdlj
council	dljjdkl
vulnerable	fjljdfafld
instance	kjsfajdd
garlic	faflkd
capability	da;afklkfj
poetry	;ldffj
celebrity	ddldffkfj
gradually	ffadjallj
stability	sfafklkfj
fantasy	fajfasj
scared	sdafdd
plot	;llf
framework	ffajdslfk
gesture	fdsfjfd
depending	dd;djdkjf
ongoing	ljflkjf
psychology	;sjdjlllfj
counselor	dljjsdllf
chapter	dja;fdf
divorce	dkflfdd
owe	lsd
pipe	;k;d
athletic	afjldfkd
slight	slkfjf
math	jafj
shade	sjadd
tail	fakl
sustain	sjsfakj
mount	jljjf
obligation	lflkfafklj
angle	ajfld
palm	;alj
differ	dkffdf
custom	djsflj
economist	ddljljksf
fifteen	fkffddj
soup	slj;
celebration	ddldffafklj
efficient	dffkdkdjf
composition	dlj;lskfklj
satisfy	safksfj
pile	;kld
briefly	ffkdflj
carbon	dafflj
closer	dllsdf
consume	dljsjjd
scheme	sdjdjd
crack	dfadk
frequency	ffdajdjdj
tobacco	flfaddl
survivor	sjffkflf
besides	fdskdds
psychologist	;sjdjlllfksf
wealthy	sdalfjj
galaxy	falasj
given	fkfdj
ski	skk
limitation	lkjkfafklj
trace	ffadd
appointment	a;;lkjfjdjf
preference	;fdfdfdjdd
meter	jdfdf
explosion	ds;llsklj
publicly	;jflkdlj
incredible	kjdfddkfld
fighter	fkfjfdf
rapid	fa;kd
admission	adjkssklj
hunter	jjjfdf
educate	ddjdafd
painful	;akjfjl
friendship	ffkdjdsjk;
aide	akdd
infant	kjfajf
calculate	daldjlafd
fifty	fkffj
rid	fkd
porch	;lfdj
tendency	fdjddjdj
uniform	jjkflfj
formation	flfjafklj
scholarship	sdjllafsjk;
reservation	fdsdffafklj
efficiency	dffkdkdjdj
qualify	ajalkfj
mall	jall
derive	ddfkfd
scandal	sdajdal
pc	;d
helpful	jdl;fjl
impress	kj;fdss
heel	jddl
resemble	fdsdjfld
privacy	;fkfadj
fabric	faffkd
contest	dljfdsf
proportion	;fl;lffklj
guideline	fjkddlkjd
rifle	fkfld
maintenance	jakjfdjajdd
conviction	dljfkdfklj
trick	ffkdk
organic	lffajkd
tent	fdjf
examination	dsajkjafklj
publisher	;jflksjdf
strengthen	sffdjffjdj
proposed	;fl;lsdd
myth	jjfj
sophisticated	sl;jksfkdafdd
cow	dls
etc	dfd
standing	sfajdkjf
asleep	asldd;
tennis	fdjjks
nerve	jdffd
barrel	faffdl
bombing	fljfkjf
membership	jdjfdfsjk;
ratio	fafkl
menu	jdjj
controversial	dljfflfdfskal
desperate	dds;dfafd
lifestyle	lkfdsfjld
humor	jjjlf
loud	lljd
glove	fllfd
sufficient	sjffkdkdjf
narrative	jaffafkfd
photographer	;jlflffa;jdf
helicopter	jdlkdl;fdf
modest	jlddsf
provider	;flfkddf
delay	ddlaj
agricultural	affkdjlfjfal
explode	ds;lldd
stroke	sfflkd
scope	sdl;d
punishment	;jjksjjdjf
handful	jajdfjl
badly	fadlj
horizon	jlfkalj
curious	djfkljs
downtown	dlsjflsj
girlfriend	fkflffkdjd
prompt	;flj;f
cholesterol	djlldsfdfll
absorb	afslff
adjustment	adjjsfjdjf
taxpayer	fas;ajdf
eager	dafdf
principal	;fkjdk;al
detailed	ddfakldd
motivation	jlfkfafklj
assignment	asskfjjdjf
restriction	fdsffkdfklj
laboratory	laflfaflfj
workshop	slfksjl;
differently	dkffdfdjflj
auto	ajfl
romantic	fljajfkd
cotton	dlfflj
motor	jlflf
sue	sjd
flavor	flaflf
overlook	lfdflllk
float	fllaf
undergo	jjddffl
sequence	sdajdjdd
demonstration	ddjljsffafklj
jet	jdf
orange	lfajfd
consumption	dljsjj;fklj
assert	assdff
blade	fladd
temporary	fdj;lfafj
medication	jddkdafklj
cabin	dafkj
bite	fkfd
edition	ddkfklj
valley	falldj
yours	jljfs
pitch	;kfdj
pine	;kjd
brilliant	ffkllkajf
versus	fdfsjs
manufacturing	jajjfadfjfkjf
absolute	afslljfd
chef	djdf
discrimination	dksdfkjkjafklj
offensive	lffdjskfd
boom	fllj
register	fdfksfdf
appoint	a;;lkjf
heritage	jdfkfafd
god	fld
dominant	dljkjajf
successfully	sjdddssfjllj
shit	sjkf
lemon	ldjlj
hungry	jjjffj
wander	sajddf
submit	sjfjkf
economics	ddljljkds
naked	jakdd
anticipate	ajfkdk;afd
nut	jjf
legacy	ldfadj
extension	dsfdjsklj
shrug	sjfjf
battery	faffdfj
arrival	affkfal
legitimate	ldfkfkjafd
orientation	lfkdjfafklj
inflation	kjflafklj
cope	dl;d
flame	flajd
cluster	dljsfdf
wound	sljjd
dependent	dd;djddjf
shower	sjlsdf
institutional	kjsfkfjfkljal
depict	dd;kdf
operating	l;dfafkjf
flesh	fldsj
garage	fafafd
operator	l;dfaflf
instructor	kjsffjdflf
collapse	dllla;sd
borrow	flffls
furthermore	fjffjdfjlfd
comedy	dljddj
mortgage	jlfffafd
sanction	sajdfklj
civilian	dkfklkaj
twelve	fsdlfd
weekly	sddklj
habitat	jafkfaf
grain	ffakj
brush	ffjsj
consciousness	dljsdkljsjdss
devote	ddflfd
measurement	jdasjfdjdjf
province	;flfkjdd
ease	dasd
seize	sdkad
ethics	dfjkds
nomination	jljkjafklj
permission	;dfjkssklj
wise	sksd
actress	adffdss
summit	sjjjkf
acid	adkd
odds	ldds
gifted	fkffdd
frustration	ffjsffafklj
medium	jddkjj
physically	;jjskdallj
distinguish	dksfkjfjksj
shore	sjlfd
repeatedly	fd;dafddlj
lung	ljjf
running	fjjjkjf
distinct	dksfkjdf
artistic	affksfkd
discourse	dksdljfsd
basket	faskdf
ah	aj
fighting	fkfjfkjf
impressive	kj;fdsskfd
competitor	dlj;dfkflf
ugly	jflj
worried	slffkdd
portray	;lfffaj
powder	;lsddf
ghost	fjlsf
persuade	;dfsjadd
moderate	jlddfafd
subsequent	sjfsdajdjf
continued	dljfkjjdd
cookie	dllkkd
carrier	daffkdf
cooking	dllkkjf
frequent	ffdajdjf
ban	faj
awful	asfjl
admire	adjkfd
pet	;df
miracle	jkfadld
exceed	dsdddd
rhythm	fjjfjj
widespread	skdds;fdad
killing	kkllkjf
lovely	llfdlj
sin	skj
charity	djafkfj
script	sdfk;f
tactic	fadfkd
identification	kddjfkfkdafklj
transformation	ffajsflfjafklj
everyday	dfdfjdaj
headline	jdadlkjd
venture	fdjfjfd
invasion	kjfasklj
nonetheless	jljdfjdldss
adequate	addajafd
piano	;kajl
grocery	fflddfj
intensity	kjfdjskfj
exhibit	dsjkfkf
blanket	flajkdf
margin	jaffkj
quarterback	ajaffdffadk
mouse	jljsd
rope	fl;d
concrete	dljdfdfd
prescription	;fdsdfk;fklj
african-american	affkdaj;ajdfkdaj
chase	djasd
brick	ffkdk
recruit	fddfjkf
patch	;afdj
consensus	dljsdjsjs
horror	jlfflf
recording	fddlfdkjf
changing	djajfkjf
painter	;akjfdf
colonial	dllljkal
pie	;kd
sake	sakd
gaze	faad
courage	dljfafd
pregnancy	;fdfjajdj
swear	ssdaf
defeat	ddfdaf
clue	dljd
reinforce	fdkjflfdd
confusion	dljfjsklj
slice	slkdd
occupation	lddj;afklj
dear	ddaf
coal	dlal
sacred	sadfdd
formula	flfjjla
cognitive	dlfjkfkfd
collective	dlllddfkfd
exact	dsadf
uncle	jjdld
captain	da;fakj
sigh	skfj
attribute	afffkfjfd
dare	dafd
homeless	jljdldss
gallery	falldfj
soccer	sldddf
defendant	ddfdjdajf
tunnel	fjjjdl
fitness	fkfjdss
lap	la;
grave	ffafd
toe	fld
container	dljfakjdf
virtue	fkffjd
abroad	afflad
architect	afdjkfddf
dramatically	dfajafkdallj
makeup	jakdj;
inquiry	kjajkfj
rose	flsd
surprisingly	sjf;fkskjflj
highlight	jkfjlkfjf
decrease	dddfdasd
indication	kjdkdafklj
rail	fakl
anniversary	ajjkfdfsafj
couch	dljdj
alliance	allkajdd
hypothesis	jj;lfjdsks
boyfriend	fljffkdjd
compose	dlj;lsd
mess	jdss
legend	ldfdjd
regulate	fdfjlafd
adolescent	adlldsddjf
shine	sjkjd
norm	jlfj
upset	j;sdf
remark	fdjafk
resign	fdskfj
reward	fdsafd
gentle	fdjfld
related	fdlafdd
organ	lffaj
lightly	lkfjflj
concerning	dljddfjkjf
invent	kjfdjf
laughter	lajfjfdf
northwest	jlffjsdsf
counseling	dljjsdlkjf
receiver	fdddkfdf
ritual	fkfjal
insect	kjsddf
interrupt	kjfdffj;f
salmon	saljlj
trading	ffadkjf
magic	jafkd
superior	sj;dfklf
combat	dljfaf
stem	sfdj
surgeon	sjffdlj
acceptable	addd;fafld
physics	;jjskds
rape	fa;d
counsel	dljjsdl
jeans	jdajs
hunt	jjjf
continuous	dljfkjjljs
log	llf
echo	ddjl
pill	;kll
excited	dsdkfdd
sculpture	sdjl;fjfd
compound	dlj;ljjd
integrate	kjfdffafd
flour	flljf
bitter	fkffdf
bare	fafd
slope	sll;d
rent	fdjf
presidency	;fdskddjdj
serving	sdffkjf
subtle	sjffld
greatly	ffdaflj
bishop	fksjl;
drinking	dfkjkkjf
acceptance	addd;fajdd
pump	;jj;
candy	dajdj
evil	dfkl
pleased	;ldasdd
medal	jddal
beg	fdf
sponsor	s;ljslf
ethical	dfjkdal
secondary	sddljdafj
slam	slaj
export	ds;lff
experimental	ds;dfkjdjfal
melt	jdlf
midnight	jkdjkfjf
curve	djffd
integrity	kjfdffkfj
entitle	djfkfld
evident	dfkddjf
logic	llfkd
essence	dssdjdd
exclude	dsdljdd
harsh	jafsj
closet	dllsdf
suburban	sjfjffaj
greet	ffddf
interior	kjfdfklf
corridor	dlffkdlf
retail	fdfakl
pitcher	;kfdjdf
march	jafdj
snake	sjakd
excuse	dsdjsd
weakness	sdakjdss
pig	;kf
classical	dlasskdal
estimated	dsfkjafdd
t-shirt	f;sjkff
unemployment	jjdj;lljjdjf
civilization	dkfklkaafklj
fold	flld
reverse	fdfdfsd
missing	jksskjf
correlation	dlffdlafklj
humanity	jjjajkfj
flash	flasj
developer	ddfdll;df
reliable	fdlkafld
excitement	dsdkfdjdjf
beef	fddf
islam	kslaj
roman	fljaj
architecture	afdjkfddfjfd
occasional	lddaskljal
administrative	adjkjksffafkfd
elbow	dlfls
deadly	ddadlj
hispanic	jks;ajkd
allegation	alldfafklj
confuse	dljfjsd
airplane	akf;lajd
monthly	jljfjlj
duck	djdk
dose	dlsd
korean	klfdaj
plead	;ldad
initiate	kjkfkafd
lecture	lddfjfd
van	faj
sixth	sksfj
bay	faj
mainstream	jakjsffdaj
suburb	sjfjff
sandwich	sajdskdj
trunk	ffjjk
rumor	fjjlf
implementation	kj;ldjdjfafklj
swallow	ssallls
motivate	jlfkfafd
render	fdjddf
longtime	lljffkjd
trap	ffa;
restrict	fdsffkdf
cloth	dllfj
seemingly	sddjkjflj
legislative	ldfkslafkfd
effectiveness	dffddfkfdjdss
enforce	djflfdd
lens	ldjs
inspector	kjs;ddflf
lend	ldjd
plain	;lakj
fraud	ffajd
companion	dlj;ajklj
contend	dljfdjd
nail	jakl
array	affaj
strict	sffkdf
assemble	assdjfld
frankly	ffajklj
rat	faf
hay	jaj
hallway	jallsaj
cave	dafd
inevitable	kjdfkfafld
southwest	sljfjsdsf
monster	jljsfdf
unexpected	jjds;ddfdd
obstacle	lfsfadld
facilitate	fadklkfafd
rip	fk;
herb	jdff
overwhelming	lfdfsjdljkjf
integration	kjfdffafklj
crystal	dfjsfal
recession	fdddssklj
written	sfkffdj
motive	jlfkfd
flood	fllld
pen	;dj
ownership	lsjdfsjk;
nightmare	jkfjfjafd
inspection	kjs;ddfklj
supervisor	sj;dffkslf
consult	dljsjlf
arena	afdja
diagnosis	dkafjlsks
possession	;lssdssklj
forgive	flffkfd
consistently	dljsksfdjflj
basement	fasdjdjf
drift	dfkff
drain	dfakj
prosecution	;flsddjfklj
maximum	jaskjjj
announcement	ajjljjddjdjf
warrior	saffklf
prediction	;fddkdfklj
bacteria	fadfdfka
questionnaire	ajdsfkljjakfd
mud	jjd
infrastructure	kjffasffjdfjfd
hurry	jjffj
privilege	;fkfkldfd
temple	fdj;ld
outdoor	ljfdllf
suck	sjdk
and/or	ajd;lf
broadcast	ffladdasf
re	fd
leap	lda;
random	fajdlj
wrist	sfksf
curtain	djffakj
pond	;ljd
domain	dljakj
guilt	fjklf
cattle	daffld
walking	salkkjf
playoff	;lajlff
minimum	jkjkjjj
fiscal	fksdal
skirt	skkff
dump	djj;
hence	jdjdd
database	dafafasd
uncomfortable	jjdljflffafld
execute	dsddjfd
limb	lkjf
ideology	kddlllfj
tune	fjjd
continuing	dljfkjjkjf
harm	jafj
railroad	faklflad
endure	djdjfd
radiation	fadkafklj
horn	jlfj
chronic	djfljkd
peaceful	;daddfjl
innovation	kjjlfafklj
strain	sffakj
guitar	fjkfaf
replacement	fd;laddjdjf
behave	fdjafd
administer	adjkjksfdf
simultaneously	skjjlfajdljslj
dancer	dajddf
amendment	ajdjdjdjf
pad	;ad
transmission	ffajsjkssklj
await	asakf
retired	fdfkfdd
trigger	ffkffdf
spill	s;kll
grateful	ffafdfjl
grace	ffadd
virtual	fkffjal
colony	dllljj
adoption	adl;fklj
indigenous	kjdkfdjljs
closed	dllsdd
convict	dljfkdf
towel	flsdl
modify	jldkfj
particle	;affkdld
prize	;fkad
landing	lajdkjf
boost	fllsf
bat	faf
alarm	alafj
festival	fdsfkfal
grip	ffk;
weird	sdkfd
undermine	jjddfjkjd
freshman	ffdsjjaj
sweat	ssdaf
outer	ljfdf
drunk	dfjjk
separation	sd;afafklj
traditionally	ffadkfkljallj
govern	flfdfj
southeast	sljfjdasf
intelligent	kjfdllkfdjf
wherever	sjdfdfdf
ballot	falllf
rhetoric	fjdflfkd
convinced	dljfkjddd
driving	dfkfkjf
vitamin	fkfajkj
enthusiasm	djfjjskasj
accommodate	addljjldafd
praise	;faksd
injure	kjjjfd
wilderness	sklddfjdss
endless	djdldss
mandate	jajdafd
respectively	fds;ddfkfdlj
uncertainty	jjddffakjfj
chaos	djals
mechanical	jddjajkdal
canvas	dajfas
forty	flffj
lobby	llffj
profound	;flfljjd
format	flfjaf
trait	ffakf
currency	djffdjdj
turkey	fjfkdj
reserve	fdsdffd
beam	fdaj
astronomer	asffljljdf
corruption	dlffj;fklj
contractor	dljffadflf
apologize	a;lllfkad
doctrine	dldffkjd
genuine	fdjjkjd
thumb	fjjjf
unity	jjkfj
compromise	dlj;fljksd
horrible	jlffkfld
behavioral	fdjafklfal
exclusive	dsdljskfd
scatter	sdaffdf
commonly	dljjljlj
convey	dljfdj
twist	fsksf
complexity	dlj;ldskfj
fork	flfk
disk	dksk
relieve	fdlkdfd
suspicion	sjs;kdklj
health-care	jdalfj;dafd
residence	fdskddjdd
shame	sjajd
meaningful	jdajkjffjl
sidewalk	skddsalk
olympics	lljj;kds
technological	fddjjlllfkdal
signature	skfjafjfd
pleasant	;ldasajf
wow	sls
suspend	sjs;djd
rebel	fdfdl
frozen	ffladj
spouse	s;ljsd
fluid	fljkd
pension	;djsklj
resume	fdsjjd
theoretical	fjdlfdfkdal
sodium	sldkjj
promotion	;fljlfklj
delicate	ddlkdafd
forehead	flfdjdad
rebuild	fdfjkld
bounce	fljjdd
electrical	dlddffkdal
hook	jllk
detective	ddfddfkfd
traveler	ffafdldf
click	dlkdk
compensation	dlj;djsafklj
exit	dskf
attraction	afffadfklj
dedicate	dddkdafd
altogether	alflfdfjdf
pickup	;kdkj;
carve	daffd
needle	jdddld
belly	fdllj
scare	sdafd
portfolio	;lfffllkl
shuttle	sjjffld
invisible	kjfkskfld
timing	fkjkjf
engagement	djfafdjdjf
ankle	ajkld
transaction	ffajsadfklj
rescue	fdsdjd
counterpart	dljjfdf;aff
historically	jksflfkdallj
firmly	fkfjlj
mild	jkld
rider	fkddf
doll	dlll
noon	jllj
amid	ajkd
identical	kddjfkdal
precise	;fddksd
anxious	ajskljs
structural	sffjdfjfal
residential	fdskddjfkal
diagnose	dkafjlsd
carbohydrate	daffljjdfafd
liberty	lkfdffj
poster	;lsfdf
theology	fjdlllfj
nonprofit	jlj;flfkf
crawl	dfasl
oxygen	lsjfdj
handsome	jajdsljd
sum	sjj
provided	;flfkddd
businessman	fjskjdssjaj
promising	;fljkskjf
conscious	dljsdkljs
determination	ddfdfjkjafklj
donor	dljlf
hers	jdfs
pastor	;asflf
jazz	jaaa
opera	l;dfa
acquisition	adajkskfklj
pit	;kf
hug	jjf
wildlife	skldlkfd
punish	;jjksj
equity	dajkfj
doorway	dllfsaj
departure	dd;affjfd
elevator	dldfaflf
teenage	fddjafd
guidance	fjkdajdd
happiness	ja;;kjdss
statue	sfafjd
pursuit	;jfsjkf
repair	fd;akf
decent	ddddjf
gym	fjj
oral	lfal
clerk	dldfk
envelope	djfdll;d
reporting	fd;lffkjf
destination	ddsfkjafklj
fist	fksf
endorse	djdlfsd
exploration	ds;llfafklj
generous	fdjdfljs
bath	fafj
thereby	fjdfdfj
indicator	kjdkdaflf
sunlight	sjjlkfjf
feedback	fdddfadk
spectrum	s;ddffjj
purple	;jf;ld
laser	lasdf
bold	flld
reluctant	fdljdfajf
starting	sfaffkjf
expertise	ds;dffksd
practically	;fadfkdallj
eating	dafkjf
hint	jkjf
sharply	sjaf;lj
parade	;afadd
realm	fdalj
cancel	dajddl
blend	fldjd
therapist	fjdfa;ksf
peel	;ddl
pizza	;kaaa
recipient	fddk;kdjf
hesitate	jdskfafd
flip	flk;
accounting	addljjfkjf
bias	fkas
huh	jjj
metaphor	jdfa;jlf
candle	dajdld
judicial	jjdkdkal
entity	djfkfj
suffering	sjffdfkjf
full-time	fjll;fkjd
lamp	laj;
garbage	faffafd
servant	sdffajf
regulatory	fdfjlaflfj
diplomatic	dk;lljafkd
elegant	dldfajf
reception	fddd;fklj
vanish	fajksj
automatically	ajfljafkdallj
chin	djkj
necessity	jdddsskfj
confess	dljfdss
racism	fadksj
starter	sfaffdf
banking	fajkkjf
casual	dasjal
gravity	ffafkfj
enroll	djflll
diminish	dkjkjksj
prevention	;fdfdjfklj
minimize	jkjkjkad
chop	djl;
performer	;dfflfjdf
intent	kjfdjf
isolate	ksllafd
inventory	kjfdjflfj
productive	;fldjdfkfd
assembly	assdjflj
civic	dkfkd
silk	sklk
magnitude	jafjkfjdd
steep	sfdd;
hostage	jlsfafd
collector	dlllddflf
popularity	;l;jlafkfj
alien	alkdj
dynamic	djjajkd
scary	sdafj
equation	dajafklj
angel	ajfdl
offering	lffdfkjf
rage	fafd
photography	;jlflffa;jj
toilet	flkldf
disappointed	dksa;;lkjfdd
precious	;fddkljs
prohibit	;fljkfkf
realistic	fdalksfkd
hidden	jkdddj
tender	fdjddf
gathering	fafjdfkjf
outstanding	ljfsfajdkjf
stumble	sfjjfld
lonely	lljdlj
automobile	ajfljlfkld
artificial	affkfkdkal
dawn	dasj
abstract	afsffadf
descend	ddsddjd
silly	skllj
tide	fkdd
shared	sjafdd
hopefully	jl;dfjllj
readily	fdadklj
cooperate	dll;dfafd
revolutionary	fdflljfkljafj
romance	fljajdd
hardware	jafdsafd
pillow	;kllls
kit	kkf
continent	dljfkjdjf
seal	sdal
circuit	dkfdjkf
ruling	fjlkjf
shortage	sjlffafd
annually	ajjjallj
lately	lafdlj
scan	sdaj
fool	flll
deadline	ddadlkjd
rear	fdaf
processing	;flddsskjf
ranch	fajdj
coastal	dlasfal
undertake	jjddffakd
softly	slfflj
burning	fjfjkjf
verbal	fdffal
tribal	ffkfal
ridiculous	fkdkdjlljs
automatic	ajfljafkd
diamond	dkajljd
credibility	dfddkfklkfj
import	kj;lff
sexually	sdsjallj
divine	dkfkjd
sentiment	sdjfkjdjf
cart	daff
oversee	lfdfsdd
o'clock	l;dlldk
elder	dlddf
pro	;fl
inspiration	kjs;kfafklj
dutch	djfdj
quantity	ajajfkfj
trailer	ffakldf
mate	jafd
greek	ffddk
genius	fdjkjs
monument	jljjjdjf
bid	fkd
quest	ajdsf
sacrifice	sadfkfkdd
invitation	kjfkfafklj
accuracy	addjfadj
juror	jjflf
officially	lffkdkallj
broker	fflkdf
treasure	ffdasjfd
loyalty	lljalfj
talented	faldjfdd
gasoline	fasllkjd
stiff	sfkff
output	ljf;jf
nominee	jljkjdd
extended	dsfdjddd
diabetes	dkafdfds
slap	sla;
toxic	flskd
alleged	alldfdd
jaw	jas
grief	ffkdf
mysterious	jjsfdfkljs
rocket	fldkdf
donate	dljafd
inmate	kjjafd
tackle	fadkld
dynamics	djjajkds
bow	fls
ours	ljfs
dignity	dkfjkfj
carpet	daf;df
parental	;afdjfal
bubble	fjffld
buddy	fjddj
barn	fafj
sword	sslfd
seventh	sdfdjfj
glory	fllfj
tightly	fkfjflj
protective	;flfddfkfd
tuck	fjdk
drum	dfjj
faint	fakjf
queen	ajddj
dilemma	dkldjja
input	kj;jf
specialize	s;ddkalkad
northeast	jlffjdasf
shallow	sjallls
liability	lkafklkfj
sail	sakl
merchant	jdfdjajf
stadium	sfadkjj
improved	kj;flfdd
bloody	fllldj
associated	assldkafdd
withdrawal	skfjdfasal
refrigerator	fdffkfdfaflf
nest	jdsf
thoroughly	fjlfljfjlj
lane	lajd
ancestor	ajddsflf
condemn	dljddjj
steam	sfdaj
accent	adddjf
optimistic	l;fkjksfkd
unite	jjkfd
cage	dafd
equip	dajk;
shrimp	sjfkj;
homeland	jljdlajd
rack	fadk
costume	dlsfjjd
wolf	sllf
courtroom	dljfffllj
statute	sfafjfd
cartoon	daffllj
productivity	;fldjdfkfkfj
grin	ffkj
symbolic	sjjfllkd
bug	fjf
bless	fldss
aunt	ajjf
agriculture	affkdjlfjfd
hostile	jlsfkld
conceive	dljddkfd
combined	dljfkjdd
instantly	kjsfajflj
bankruptcy	fajkfj;fdj
vaccine	faddkjd
bonus	fljjs
collaboration	dlllaflfafklj
mixed	jksdd
opposed	l;;lsdd
orbit	lffkf
grasp	ffas;
patience	;afkdjdd
spite	s;kfd
tropical	ffl;kdal
voting	flfkjf
patrol	;affll
willingness	skllkjfjdss
revelation	fdfdlafklj
calm	dalj
jewelry	jdsdlfj
cuban	djfaj
haul	jajl
concede	dljdddd
wagon	saflj
afterward	affdfsafd
spectacular	s;ddfadjlaf
ruin	fjkj
sheer	sjddf
immune	kjjjjd
reliability	fdlkafklkfj
ass	ass
alongside	alljfskdd
bush	fjsj
exotic	dslfkd
fascinating	fasdkjafkjf
clip	dlk;
thigh	fjkfj
bull	fjll
drawer	dfasdf
sheep	sjdd;
discourage	dksdljfafd
coordinator	dllfdkjaflf
ideological	kddlllfkdal
runner	fjjjdf
secular	sddjlaf
intimate	kjfkjafd
empire	dj;kfd
cab	daf
exam	dsaj
documentary	dldjjdjfafj
neutral	jdjffal
biology	fklllfj
flexible	fldskfld
progressive	;flffdsskfd
web	sdf
conspiracy	dljs;kfadj
casualty	dasjalfj
republic	fd;jflkd
execution	dsddjfklj
terrific	fdffkfkd
whale	sjald
functional	fjjdfkljal
instinct	kjsfkjdf
teammate	fdajjafd
aluminum	aljjkjjj
whoever	sjldfdf
ministry	jkjksffj
verdict	fdfdkdf
instruct	kjsffjdf
skull	skjll
self-esteem	sdlf;dsfddj
cooperative	dll;dfafkfd
manipulate	jajk;jlafd
bee	fdd
practitioner	;fadfkfkljdf
loop	lll;
edit	ddkf
whip	sjk;
puzzle	;jaald
mushroom	jjsjfllj
subsidy	sjfskdj
boil	flkl
tragic	ffafkd
mathematics	jafjdjafkds
mechanic	jddjajkd
jar	jaf
earthquake	daffjajakd
pork	;lfk
creativity	dfdafkfkfj
safely	safdlj
underlying	jjddfljkjf
dessert	ddssdff
sympathy	sjj;afjj
fisherman	fksjdfjaj
incredibly	kjdfddkflj
isolation	ksllafklj
sock	sldk
eleven	dldfdj
sexy	sdsj
entrepreneur	djffd;fdjdjf
syndrome	sjjdfljd
bureau	fjfdaj
workplace	slfk;ladd
ambition	ajfkfklj
touchdown	fljdjdlsj
utilize	jfklkad
breeze	ffddad
costly	dlsflj
ambitious	ajfkfkljs
christianity	djfksfkajkfj
presumably	;fdsjjaflj
influential	kjfljdjfkal
translation	ffajslafklj
uncertain	jjddffakj
dissolve	dkssllfd
statistical	sfafksfkdal
gut	fjf
metropolitan	jdffl;llkfaj
rolling	flllkjf
aesthetic	adsfjdfkd
spell	s;dll
insert	kjsdff
booth	fllfj
helmet	jdljdf
waist	saksf
expected	ds;ddfdd
lion	lklj
accomplishment	addlj;lksjjdjf
royal	fljal
panic	;ajkd
crush	dfjsj
actively	adfkfdlj
cliff	dlkff
minimal	jkjkjal
cord	dlfd
fortunately	flffjjafdlj
cocaine	dldakjd
illusion	klljsklj
anonymous	ajljjjljs
tolerate	flldfafd
appreciation	a;;fddkafklj
commissioner	dljjksskljdf
flexibility	fldskfklkfj
instructional	kjsffjdfkljal
scramble	sdfajfld
casino	daskjl
tumor	fjjlf
decorate	dddlfafd
pulse	;jlsd
equivalent	dajkfaldjf
fixed	fksdd
experienced	ds;dfkdjddd
donation	dljafklj
diary	dkafj
sibling	skflkjf
irony	kfljj
spoon	s;llj
midst	jkdsf
alley	alldj
interact	kjfdfadf
soap	sla;
cute	djfd
rival	fkfal
short-term	sjlff;fdfj
punch	;jjdj
pin	;kj
hockey	jldkdj
passing	;asskjf
persist	;dfsksf
supplier	sj;;lkdf
known	kjlsj
momentum	jljdjfjj
purse	;jfsd
shed	sjdd
liquid	lkajkd
icon	kdlj
elephant	dld;jajf
consequently	dljsdajdjflj
legislature	ldfkslafjfd
franchise	ffajdjksd
correctly	dlffddflj
mentally	jdjfallj
foster	flsfdf
bicycle	fkdjdld
encouraging	djdljfafkjf
cheat	djdaf
heal	jdal
fever	fdfdf
filter	fklfdf
rabbit	faffkf
coin	dlkj
exploit	ds;llkf
accessible	adddsskfld
organism	lffajksj
sensation	sdjsafklj
partially	;affkallj
upstairs	j;sfakfs
dried	dfkdd
conservation	dljsdffafklj
shove	sjlfd
backyard	fadkjafd
charter	djaffdf
stove	sflfd
consent	dljsdjf
comprise	dlj;fksd
reminder	fdjkjddf
alike	alkkd
placement	;laddjdjf
dough	dljfj
grandchild	ffajddjkld
dam	daj
reportedly	fd;lffddlj
well-known	sdll;kjlsj
surrounding	sjffljjdkjf
ecological	ddlllfkdal
outfit	ljffkf
unprecedented	jj;fdddddjfdd
columnist	dlljjjksf
workout	slfkljf
preliminary	;fdlkjkjafj
patent	;afdjf
shy	sjj
trash	ffasj
disabled	dksafldd
gross	fflss
damn	dajj
hormone	jlfjljd
texture	fdsfjfd
pencil	;djdkl
frontier	ffljfkdf
spray	s;faj
disclose	dksdllsd
custody	djsfldj
banker	fajkdf
beast	fdasf
interfere	kjfdffdfd
oak	lak
eighth	dkfjfj
notebook	jlfdfllk
outline	ljflkjd
attendance	affdjdajdd
speculation	s;ddjlafklj
uncover	jjdlfdf
behalf	fdjalf
innovative	kjjlfafkfd
shark	sjafk
mill	jkll
installation	kjsfallafklj
stimulate	sfkjjlafd
tag	faf
vertical	fdffkdal
swimming	sskjjkjf
fleet	flddf
catalog	dafallf
outsider	ljfskddf
desperately	dds;dfafdlj
stance	sfajdd
compel	dlj;dl
sensitivity	sdjskfkfkfj
someday	sljddaj
instant	kjsfajf
debut	ddfjf
proclaim	;fldlakj
worldwide	slfldskdd
hike	jkkd
required	fdajkfdd
confrontation	dljffljfafklj
colorful	dlllffjl
constitution	dljsfkfjfklj
trainer	ffakjdf
thanksgiving	fjajksfkfkjf
scent	sddjf
stack	sfadk
eyebrow	djdffls
sack	sadk
cease	ddasd
inherit	kjjdfkf
tray	ffaj
pioneer	;kljddf
organizational	lffajkaafkljal
textbook	fdsffllk
uh	jj
nasty	jasfj
shrink	sjfkjk
emerging	djdffkjf
dot	dlf
wheat	sjdaf
fierce	fkdfdd
envision	djfksklj
rational	fafkljal
kingdom	kkjfdlj
aisle	aksld
weaken	sdakdj
protocol	;flfldll
exclusively	dsdljskfdlj
vocal	fldal
marketplace	jafkdf;ladd
openly	l;djlj
unfair	jjfakf
terrain	fdffakj
deploy	dd;llj
risky	fkskj
pasta	;asfa
genre	fdjfd
distract	dksffadf
merit	jdfkf
planner	;lajjdf
depressed	dd;fdssdd
chunk	djjjk
closest	dllsdsf
discount	dksdljjf
ladder	ladddf
jungle	jjjfld
migration	jkffafklj
breathing	ffdafjkjf
invade	kjfadd
hurricane	jjffkdajd
retailer	fdfakldf
classify	dlasskfj
coup	dlj;
ambassador	ajfassadlf
density	ddjskfj
supportive	sj;;lffkfd
curiosity	djfklskfj
skip	skk;
aggression	afffdssklj
stimulus	sfkjjljs
journalism	jljfjalksj
robot	flflf
dip	dk;
likewise	lkkdsksd
informal	kjflfjal
persian	;dfskaj
feather	fdafjdf
sphere	s;jdfd
tighten	fkfjfdj
boast	flasf
pat	;af
perceived	;dfddkfdd
sole	slld
publicity	;jflkdkfj
unfold	jjflld
well-being	sdll;fdkjf
validity	falkdkfj
ecosystem	ddlsjsfdj
strictly	sffkdflj
partial	;affkal
collar	dlllaf
weed	sddd
compliance	dlj;lkajdd
streak	sffdak
supposedly	sj;;lsddlj
added	adddd
builder	fjklddf
glimpse	flkj;sd
premise	;fdjksd
specialty	s;ddkalfj
deem	dddj
artifact	affkfadf
sneak	sjdak
monkey	jljkdj
mentor	jdjflf
two-thirds	fsl;fjkfds
listener	lksfdjdf
lightning	lkfjfjkjf
legally	ldfallj
sleeve	slddfd
disappointment	dksa;;lkjfjdjf
disturb	dksfjff
rib	fkf
excessive	dsddsskfd
high-tech	jkfj;fddj
debris	ddffks
rod	fld
logical	llfkdal
ash	asj
socially	sldkallj
parish	;afksj
slavery	slafdfj
blank	flajk
commodity	dljjldkfj
cure	djfd
mineral	jkjdfal
hunger	jjjfdf
dying	djkjf
developmental	ddfdll;jdjfal
faster	fasfdf
spare	s;afd
halfway	jalfsaj
equality	dajalkfj
cemetery	ddjdfdfj
harassment	jafassjdjf
deliberately	ddlkfdfafdlj
fame	fajd
regret	fdffdf
striking	sffkkkjf
likelihood	lkkdlkjlld
carrot	dafflf
atop	afl;
toll	flll
rim	fkj
embarrassed	djfaffassdd
fucking	fjdkkjf
cling	dlkjf
isolated	ksllafdd
blink	flkjk
suspicious	sjs;kdkljs
wheelchair	sjddldjakf
squad	sajad
eligible	dlkfkfld
processor	;flddsslf
plunge	;ljjfd
demographic	ddjlffa;jkd
chill	djkll
refuge	fdfjfd
steer	sfddf
legislator	ldfkslaflf
rally	fallj
programming	;flffajjkjf
cheer	djddf
outlet	ljfldf
intact	kjfadf
vendor	fdjdlf
thrive	fjfkfd
peanut	;dajjf
chew	djds
elaborate	dlaflfafd
conception	dljdd;fklj
auction	ajdfklj
steak	sfdak
comply	dlj;lj
triumph	ffkjj;j
shareholder	sjafdjllddf
comparable	dlj;afafld
transport	ffajs;lff
conscience	dljsdkdjdd
calculation	daldjlafklj
considerably	dljskddfaflj
interval	kjfdffal
scratch	sdfafdj
awake	asakd
jurisdiction	jjfksdkdfklj
inevitably	kjdfkfaflj
feminist	fdjkjksf
constraint	dljsffakjf
emotionally	djlfkljallj
expedition	ds;ddkfklj
allegedly	alldfddlj
similarity	skjklafkfj
butt	fjff
lid	lkd
dumb	djjf
bulk	fjlk
sprinkle	s;fkjkld
mortality	jlffalkfj
philosophical	;jkllsl;jkdal
conversion	dljfdfsklj
patron	;afflj
municipal	jjjkdk;al
liver	lkfdf
harmony	jafjljj
solely	slldlj
tolerance	flldfajdd
goat	flaf
blessing	fldsskjf
banana	fajaja
palace	;aladd
formerly	flfjdflj
peasant	;dasajf
neat	jdaf
grandparent	ffajd;afdjf
lawmaker	lasjakdf
supermarket	sj;dfjafkdf
cruise	dfjksd
mobile	jlfkld
calendar	daldjdaf
widow	skdls
deposit	dd;lskf
beard	fdafd
brake	ffakd
screening	sdfddjkjf
impulse	kj;jlsd
forbid	flffkd
fur	fjf
brutal	ffjfal
predator	;fddaflf
poke	;lkd
opt	l;f
voluntary	flljjfafj
valid	falkd
forum	flfjj
dancing	dajdkjf
happily	ja;;klj
soar	slaf
removal	fdjlfal
autonomy	ajfljljj
enact	djadf
thread	fjfdad
landmark	lajdjafk
unhappy	jjja;;j
offender	lffdjddf
coming	dljkjf
privately	;fkfafdlj
fraction	ffadfklj
distinctive	dksfkjdfkfd
tourism	fljfksj
threshold	fjfdsjlld
routinely	fljfkjdlj
suite	sjkfd
regulator	fdfjlaflf
straw	sffas
theological	fjdlllfkdal
exhaust	dsjajsf
globe	fllfd
fragile	ffafkld
objection	lfjddfklj
chemistry	djdjksffj
old-fashioned	lld;fasjkljdd
crowded	dflsddd
blast	flasf
prevail	;fdfakl
overnight	lfdfjkfjf
denial	ddjkal
rental	fdjfal
fantastic	fajfasfkd
fragment	ffafjdjf
screw	sdfds
warmth	safjfj
undergraduate	jjddfffadjafd
headache	jdadadjd
policeman	;llkddjaj
projection	;fljddfklj
suitable	sjkfafld
graduation	ffadjafklj
drill	dfkll
cruel	dfjdl
mansion	jajsklj
grape	ffa;d
authorize	ajfjlfkad
cottage	dlffafd
driveway	dfkfdsaj
charm	djafj
sexuality	sdsjalkfj
loyal	lljal
clay	dlaj
balloon	fallllj
invention	kjfdjfklj
ego	dfl
fare	fafd
homework	jljdslfk
disc	dksd
sofa	slfa
availability	afaklafklkfj
radar	fadaf
frown	fflsj
regain	fdfakj
sweater	ssdafdf
rehabilitation	fdjafklkfafklj
rubber	fjffdf
retreat	fdffdaf
molecule	jllddjld
freely	ffddlj
favorable	faflfafld
steadily	sfdadklj
integrated	kjfdffafdd
ha	ja
youngster	jljjfsfdf
premium	;fdjkjj
accountability	addljjfafklkfj
overwhelm	lfdfsjdlj
one-third	ljd;fjkfd
contemplate	dljfdj;lafd
update	j;dafd
spark	s;afk
ironically	kfljkdallj
fatigue	fafkfjd
speculate	s;ddjlafd
marker	jafkdf
preach	;fdadj
bucket	fjdkdf
blond	flljd
confession	dljfdssklj
provoke	;flflkd
marble	jaffld
substantially	sjfsfajfkallj
defender	ddfdjddf
explicit	ds;lkdkf
disturbing	dksfjffkjf
surveillance	sjffdkllajdd
magnetic	jafjdfkd
technician	fddjjkdkaj
mutter	jjffdf
devastating	ddfasfafkjf
depart	dd;aff
arrow	affls
trauma	ffajja
neighboring	jdkfjflfkjf
soak	slak
ribbon	fkfflj
meantime	jdajfkjd
transmit	ffajsjkf
harvest	jaffdsf
consecutive	dljsddjfkfd
coordinate	dllfdkjafd
spy	s;j
slot	sllf
riot	fklf
nutrient	jjffkdjf
citizenship	dkfkadjsjk;
severely	sdfdfdlj
sovereignty	slfdfdkfjfj
ridge	fkdfd
brave	ffafd
lighting	lkfjfkjf
specify	s;ddkfj
contributor	dljffkfjflf
frustrate	ffjsffafd
articulate	affkdjlafd
importantly	kj;lffajflj
transit	ffajskf
dense	ddjsd
seminar	sdjkjaf
electronics	dlddffljkds
sunny	sjjjj
shorts	sjlffs
swell	ssdll
accusation	addjsafklj
soften	slffdj
straighten	sffakfjfdj
terribly	fdffkflj
cue	djd
bride	ffkdd
biography	fklffa;jj
hazard	jaaafd
compelling	dlj;dllkjf
seldom	sdldlj
tile	fkld
economically	ddljljkdallj
honestly	jljdsflj
troubled	ffljfldd
twentieth	fsdjfkdfj
balanced	falajddd
foreigner	flfdkfjdf
convenience	dljfdjkdjdd
delight	ddlkfjf
weave	sdafd
timber	fkjfdf
till	fkll
accurately	addjfafdlj
plea	;lda
bulb	fjlf
flying	fljkjf
sustainable	sjsfakjafld
devil	ddfkl
bolt	fllf
cargo	daffl
spine	s;kjd
seller	sdlldf
skilled	skklldd
managing	jajafkjf
marine	jafkjd
dock	dldk
organized	lffajkadd
fog	flf
diplomat	dk;lljaf
boring	flfkjf
sometime	sljdfkjd
summary	sjjjafj
missionary	jksskljafj
epidemic	d;kddjkd
fatal	fafal
trim	ffkj
warehouse	safdjljsd
accelerate	adddldfafd
butterfly	fjffdfflj
bronze	ffljad
drown	dflsj
inherent	kjjdfdjf
nationwide	jafkljskdd
spit	s;kf
kneel	kjddl
vacuum	fadjjj
selected	sdlddfdd
dictate	dkdfafd
